id	title	year	reason
tamascelli_academic_2025	Academic {Advising} {Chatbot} {Powered} with {AI} {Agent}	2025	Ambiguo sin abstract
quinn_accelerating_2025	Accelerating {Retrieval}-{Augmented} {Generation}	2025	Ambiguo sin abstract
zhang_survey_2025	A {Survey} of {Theory} {Foundation} and {Key} {Technology} in {Large} {Models}	2025	Ambiguo sin abstract
sun_adaptive_2024	Adaptive {In}-{Context} {Learning} with {Large} {Language} {Models} for {Bundle} {Generation}	2024	Ambiguo sin abstract
sun_persona-l_2025	Persona-{L} has {Entered} the {Chat}: {Leveraging} {LLMs} and {Ability}-based {Framework} for {Personas} of {People} with {Complex} {Needs}	2025	Ambiguo sin abstract
shokrnezhad_autonomous_2025	An {Autonomous} {Network} {Orchestration} {Framework} {Integrating} {Large} {Language} {Models} with {Continual} {Reinforcement} {Learning}	2025	Ambiguo sin abstract
singh_adversarial_2024	Adversarial {Training} of {Retrieval} {Augmented} {Generation} to {Generate} {Believable} {Fake} {News}	2024	Ambiguo sin abstract
noauthor_ieee_nodate	{IEEE} {Xplore} {Search} {Results}		Año desconocido
lahiri_alzheimerrag_2025	{AlzheimerRAG}: {Multimodal} {Retrieval}-{Augmented} {Generation} for {Clinical} {Use} {Cases}	2025	Ambiguo sin abstract
vrdoljak_review_2025	A {Review} of {Large} {Language} {Models} in {Medical} {Education}, {Clinical} {Decision} {Support}, and {Healthcare} {Administration}	2025	Ambiguo sin abstract
ma_knowledge-graph_2025	A knowledge-graph enhanced large language model-based fault diagnostic reasoning and maintenance decision support pipeline towards industry 5.0	2025	Ambiguo sin abstract
bhattacharya_study_2025	A {Study} on {Effect} of {Reference} {Knowledge} {Choice} in {Generating} {Technical} {Content} {Relevant} to {SAPPhIRE} {Model} {Using} {Large} {Language} {Model}	2025	Ambiguo sin abstract
malin_review_2025	A review of faithfulness metrics for hallucination assessment in {Large} {Language} {Models}	2025	Ambiguo sin abstract
ieva_retrieval-augmented_2024	A {Retrieval}-{Augmented} {Generation} {Approach} for {Data}-{Driven} {Energy} {Infrastructure} {Digital} {Twins}	2024	Ambiguo sin abstract
parmanto_reliable_2024	A {Reliable} and {Accessible} {Caregiving} {Language} {Model} ({CaLM}) to {Support} {Tools} for {Caregivers}: {Development} and {Evaluation} {Study}	2024	Ambiguo sin abstract
ghanbari_haez_retrieval-augmented_2024	A {Retrieval}-{Augmented} {Generation} {Strategy} to {Enhance} {Medical} {Chatbot} {Reliability}	2024	Ambiguo sin abstract
liu_detecting_2025	Detecting emergencies in patient portal messages using large language models and knowledge graph-based retrieval-augmented generation	2025	Ambiguo sin abstract
jeong_retrieval-augmented_2024	Retrieval-{Augmented} {Generation}-based {Question} {Answering} {Technology} for {Construction} {Safety}	2024	Ambiguo sin abstract
li_refai_2024	{RefAI}: a {GPT}-powered retrieval-augmented generative tool for biomedical literature recommendation and summarization	2024	Ambiguo sin abstract
pahwa_reliable_2024	Reliable {Medical} {LLM} and {Vision}-{Language} {RAG} through {Multi}-{Agent} {Orchestration} and {Single}-{Step} {Preference} {Alignment}	2024	Ambiguo sin abstract
comendant_large_2024	Large language model-based sport coaching system using retrieval-augmented generation and user models	2024	Ambiguo sin abstract
yang_implementation_2025	Implementation of {Retrieval} {Augmented} {Generation} ({RAG}) {Model} {Using} {LLM}: {A} {RapidMiner}-{Based} {Approach}	2025	Ambiguo sin abstract
park_development_2024	Development of dental consultation chatbot using retrieval augmented llm	2024	Ambiguo sin abstract
mohammed_diabetiq_nodate	{DiabetIQ}: {An} {Intelligent} {Diabetes} {Management} {Application} with an {Integrated} {LLM}-{Augmented} {RAG} {Chatbot} and {ML}-{Based} {Risk} {Early} {Prediction}		Año desconocido
shin_qa_2023	{QA} {Pair} {Passage} {RAG}-based {LLM} {Korean} chatbot service	2023	Ambiguo sin abstract
kang_bim_2024	{BIM} knowledge expert agent research based on {LLM} and {RAG}	2024	Ambiguo sin abstract
jeong_generative_2023	Generative {AI} service implementation using {LLM} application architecture: based on {RAG} model and {LangChain} framework	2023	Ambiguo sin abstract
zeng_cancer_2025	Cancer gene identification through integrating causal prompting large language model with omics data–driven causal inference	2025	Ambiguo sin abstract
zheng_-device_nodate	On-{Device} {Hybrid} {LLM}-{RAG} {Agents} for {Adaptive} {Display} {Optimization}		Año desconocido
noauthor_scopus_nodate	Scopus - {Document} search results {\textbar} {Signed} in - 25/10/2025		Año desconocido
chen_leveraging_2025	Leveraging large language models to assist philosophical counseling: prospective techniques, value, and challenges	2025	Ambiguo sin abstract
tsai_notitle_2025		2025	Ambiguo sin abstract
waterman_custom_2025	A {Custom} {GPT} for {Executive} {MBA} {Students}: {A} {Case} {Study} in {Enhancing} {Learning}	2025	Ambiguo sin abstract
zhai_rag-ler_2025	{RAG}-{LER}: {Ranking} adapted generation with language-model enabled regulation	2025	Ambiguo sin abstract
wang_retrieval_2025	A retrieval augmented generation based optimization approach for medical knowledge understanding and reasoning in large language models	2025	Ambiguo sin abstract
nahar_catch_2025	Catch me if you search: {When} contextual web search results affect the detection of hallucinations	2025	Ambiguo sin abstract
song_graph_2025	Graph retrieval augmented large language models for facial phenotype associated rare genetic disease	2025	Ambiguo sin abstract
garcia_improving_2025	Improving automated deep phenotyping through large language models using retrieval-augmented generation	2025	Ambiguo sin abstract
sun_humanmod_2025	{HumanMoD}: {A} multi-{RAG} collaborative {LLM} for inclusive urban public healthcare services	2025	Ambiguo sin abstract
barrit_specialized_2025	Specialized {AI} and neurosurgeons in niche expertise: a proof-of-concept in neuromodulation with vagus nerve stimulation	2025	Ambiguo sin abstract
edelman_valsci_2025	Valsci: an open-source, self-hostable literature review utility for automated large-batch scientific claim verification using large language models	2025	Ambiguo sin abstract
xie_intelligent_2025	An intelligent guided troubleshooting method for aircraft based on {HybirdRAG}	2025	Ambiguo sin abstract
umer_transforming_2025	Transforming education: tackling the two sigma problem with {AI} in journal clubs – a proof of concept	2025	Ambiguo sin abstract
zhang_leveraging_2025	Leveraging long context in retrieval augmented language models for medical question answering	2025	Ambiguo sin abstract
ke_retrieval_2025	Retrieval augmented generation for 10 large language models and its generalizability in assessing medical fitness	2025	Ambiguo sin abstract
goodell_large_2025	Large language model agents can use tools to perform clinical calculations	2025	Ambiguo sin abstract
zhang_treeqa_2025	{TreeQA}: {Enhanced} {LLM}-{RAG} with logic tree reasoning for reliable and interpretable multi-hop question answering	2025	Ambiguo sin abstract
de_jesus_enhanced_2025	Enhanced {LLM}-supported instructions for medication use through retrieval-augmented generation	2025	Ambiguo sin abstract
adanza_leveraging_2025	Leveraging generative {AI} for intent-based networking operations in network slices	2025	Ambiguo sin abstract
shi_fine-tuning_2025	Fine-tuning a large language model for automated code compliance of building regulations	2025	Ambiguo sin abstract
mondillo_artificial_2025	Artificial intelligence for solving pediatric clinical cases: {A} {Retrieval}-{Augmented} approach utilizing {Llama3}.2 and structured references	2025	Ambiguo sin abstract
zhang_notitle_2025		2025	Ambiguo sin abstract
shunmuga_priya_gender_2025	Gender inclusive language generation framework: {A} reasoning approach with {RAG} and {CoT}	2025	Ambiguo sin abstract
ozmen_specialized_2025	Specialized {Artificial} {Intelligence} {Clinical} {Decision} {Support} {System} for {Aesthetic} {Surgery}: {Aesthetic} {Surgery} {Using} {Retrieval} {Augmentation} ({AURA})	2025	Ambiguo sin abstract
guo_leveraging_2025	Leveraging inter-chunk interactions for enhanced retrieval in large language model-based question answering	2025	Ambiguo sin abstract
null_notitle_2025		2025	Ambiguo sin abstract
null_notitle_2025-1		2025	Ambiguo sin abstract
wei_rtphy-chatbot_2025	{RTPhy}-{ChatBot}: {A} {RAG}-{Based} intelligent assistant for radiotherapy physics using {LLaMA3} and {AAPM} reports	2025	Ambiguo sin abstract
bayram_evaluating_2025	Evaluating {AI}-{Generated} {Meal} {Plans} for {Simulated} {Diabetes} {Profiles}: {A} {Guideline}-{Based} {Comparison} of {Three} {Language} {Models}	2025	Ambiguo sin abstract
cruzes_revolutionizing_2025	Revolutionizing optical networks: {The} integration and impact of large language models	2025	Ambiguo sin abstract
ding_enhancing_2025	Enhancing graph multi-hop reasoning for question answering with {LLMs}: {An} approach based on adaptive path generation	2025	Ambiguo sin abstract
pimpale_legalmind_2025	{LEGALMIND}: {A} {FINE}-{TUNED} {GEMMA}-2-{BASED} {LEGAL} {ASSISTANT} {FOR} {INDIAN} {JUDICIARY} {WITH} {RAG} {AND} {EMBEDDING} {INTEGRATION}	2025	Ambiguo sin abstract
kang_similarity_2025	Similarity {Evaluation} and {Fine}-{Tuning} of {Embedding} {Models} from {Various} {Linguistic} {Perspectives}	2025	Ambiguo sin abstract
kaufmes_evaluating_2025	Evaluating {Medium} {Scale}, {Open}-{Source} {Large} {Language} {Models}: {Towards} {Decision} {Support} in a {Precision} {Oncology} {Care} {Delivery} {Context}	2025	Ambiguo sin abstract
malik_evaluating_2025	Evaluating {Artificial} {Intelligence}-{Driven} {Responses} to {Acute} {Liver} {Failure} {Queries}: {A} {Comparative} {Analysis} {Across} {Accuracy}, {Clarity}, and {Relevance}	2025	Ambiguo sin abstract
feyijimi_chatgpts_2025	{ChatGPT}’s {Expanding} {Horizons} and {Transformative} {Impact} {Across} {Domains}: {A} {Critical} {Review} of {Capabilities}, {Challenges}, and {Future} {Directions}	2025	Ambiguo sin abstract
ibrahim_mera_2025	{MERA}: {Medical} {Electronic} {Records} {Assistant}	2025	Ambiguo sin abstract
kovari_ai_2025	{AI} {Gem}: {Context}-{Aware} {Transformer} {Agents} as {Digital} {Twin} {Tutors} for {Adaptive} {Learning}	2025	Ambiguo sin abstract
ersahin_bedside_2025	From {Bedside} to {Bot}-{Side}: {Artificial} {Intelligence} in {Emergency} {Appendicitis} {Management}	2025	Ambiguo sin abstract
neha_retrieval-augmented_2025	Retrieval-{Augmented} {Generation} ({RAG}) in {Healthcare}: {A} {Comprehensive} {Review}	2025	Ambiguo sin abstract
syahputri_unlocking_2025	Unlocking the {Potential} of the {Prompt} {Engineering} {Paradigm} in {Software} {Engineering}: {A} {Systematic} {Literature} {Review}	2025	Ambiguo sin abstract
tebourbi_bpmn-based_2025	{BPMN}-{Based} {Design} of {Multi}-{Agent} {Systems}: {Personalized} {Language} {Learning} {Workflow} {Automation} with {RAG}-{Enhanced} {Knowledge} {Access} †	2025	Ambiguo sin abstract
mokashi_analysis_2025	Analysis of {Large} {Language} {Models} for {Company} {Annual} {Reports} {Based} on {Retrieval}-{Augmented} {Generation}	2025	Ambiguo sin abstract
lee_memory-augmented_2025	Memory-{Augmented} {Large} {Language} {Model} for {Enhanced} {Chatbot} {Services} in {University} {Learning} {Management} {Systems}	2025	Ambiguo sin abstract
jung_intelligent_2025	An {Intelligent} {Docent} {System} with a {Small} {Large} {Language} {Model} ({sLLM}) {Based} on {Retrieval}-{Augmented} {Generation} ({RAG})	2025	Ambiguo sin abstract
liu_reapr_2025	{ReAPR}: {Automatic} program repair via retrieval-augmented large language models	2025	Ambiguo sin abstract
forootani_bio-eng-llm_2025	Bio-{Eng}-{LLM} {AI} {Assist}: {A} modular chatbot platform for interdisciplinary research and education	2025	Ambiguo sin abstract
proestel_semantic_2025	Semantic {Search} of {FDA} {Guidance} {Documents} {Using} {Generative} {AI}	2025	Ambiguo sin abstract
do_esac_2025	{ESAC} ({EQ}-{SANS} {Assisting} {Chatbot}): {Application} of large language models and retrieval-augmented generation for enhanced user experience at {EQ}-{SANS}	2025	Ambiguo sin abstract
most_lost_2025	Lost in {OCR} {Translation}? {Vision}-{Based} {Approaches} to {Robust} {Document} {Retrieval}	2025	Ambiguo sin abstract
silva_ai-assisted_2025	{AI}-{Assisted} {Tools} for {Scientific} {Review} {Writing}: {Opportunities} and {Cautions}	2025	Ambiguo sin abstract
zhang_plantgpt_2025	{PlantGPT}: {An} {Arabidopsis}-{Based} {Intelligent} {Agent} that {Answers} {Questions} about {Plant} {Functional} {Genomics}	2025	Ambiguo sin abstract
kuroda_cocktailai_2025	{CocktailAI}: {Discharge} {Summary} {Generator} {Using} {Template} {Document} and {Retrieval}-{Augmented} {Generation}, and {Hybrid}-{Cloud} {Hospital} {Information} {System} {Platform} to {Enable} {It}	2025	Ambiguo sin abstract
shah_retrieval_2025	Retrieval {Augmented} {Generation} {System} for {Mental} {Health} {Information}	2025	Ambiguo sin abstract
segalini_tanagpt_2025	Tanagpt: {How} {Can} {I} {Help} {You}? {A} {Pilot} {Testing} of a {Genai} {Assistant} in a {Healthcare} {Workflow}	2025	Ambiguo sin abstract
jiang_retrieval_2025	Retrieval {And} {Structuring} {Augmented} {Generation} with {Large} {Language} {Models}	2025	Ambiguo sin abstract
xin_atomr_2025	{AtomR}: {Atomic} {Operator}-{Empowered} {Large} {Language} {Models} for {Heterogeneous} {Knowledge} {Reasoning}	2025	Ambiguo sin abstract
huang_prompting_2025	Prompting large language models with knowledge graphs for question answering involving long-tail facts	2025	Ambiguo sin abstract
shahraki_big_2025	Big {Data} {Technology} {Trends} in {Transportation} {Leveraging} a {Large} {Language} {Model}-{Based} {System}	2025	Ambiguo sin abstract
welsh_custom-tailored_2025	Custom-{Tailored} {Radiology} {Research} via {Retrieval}-{Augmented} {Generation}: {A} {Secure} {Institutionally} {Deployed} {Large} {Language} {Model} {System}	2025	Ambiguo sin abstract
papageorgiou_role_2025	The {Role} of {Large} {Language} {Models} in {Improving} {Diagnostic}-{Related} {Groups} {Assignment} and {Clinical} {Decision} {Support} in {Healthcare} {Systems}: {An} {Example} from {Radiology} and {Nuclear} {Medicine}	2025	Ambiguo sin abstract
zhao_mdkag_2025	{MDKAG}: {Retrieval}-{Augmented} {Educational} {QA} {Powered} by a {Multimodal} {Disciplinary} {Knowledge} {Graph}	2025	Ambiguo sin abstract
dos_santos-junior_ai-assisted_2025	An {AI}-{Assisted} {Thermodynamic} {Equilibrium} {Simulator}: {A} {Case} {Study} on {Steam} {Methane} {Reforming} in {Isothermal} and {Adiabatic} {Reactors}	2025	Ambiguo sin abstract
liu_spatiotemporalsemantic_2025	A {Spatiotemporal}–{Semantic} {Coupling} {Intelligent} {Q}\&{A} {Method} for {Land} {Use} {Approval} {Based} on {Knowledge} {Graphs} and {Intelligent} {Agents}	2025	Ambiguo sin abstract
smajic_large_2025	Large {Language} {Models} for {Structured} and {Semi}-{Structured} {Data}, {Recommender} {Systems} and {Knowledge} {Base} {Engineering}: {A} {Survey} of {Recent} {Techniques} and {Architectures}	2025	Ambiguo sin abstract
du_knowledge-augmented_2025	Knowledge-{Augmented} {Zero}-{Shot} {Method} for {Power} {Equipment} {Defect} {Grading} with {Chain}-of-{Thought} {LLMs}	2025	Ambiguo sin abstract
hu_intelligent_2025	Intelligent assistant in radiation protection based on large language model with knowledge base	2025	Ambiguo sin abstract
kelly_folkrag_2025	{FolkRAG}: a retrieval-augmented generation system for cultural heritage materials	2025	Ambiguo sin abstract
almeida_artificial_2025	Artificial {Intelligence} in {Anesthesia} {Enters} the {Evidence}-{Based} {Era} with {Retrieval}-{Augmented} {Generation}	2025	Ambiguo sin abstract
naagarajan_enhancing_2025	Enhancing greenhouse management with interpretable {AI}: {A} natural language interface for advanced and optimization-based control	2025	Ambiguo sin abstract
baek_automated_2025	Automated safety risk management guidance enhanced by retrieval-augmented large language model	2025	Ambiguo sin abstract
yang_ragva_2025	{RAGVA}: {Engineering} retrieval augmented generation-based virtual assistants in practice	2025	Ambiguo sin abstract
markey_rags_2025	From {RAGs} to riches: {Utilizing} large language models to write documents for clinical trials	2025	Ambiguo sin abstract
yang_evaluating_2025	Evaluating {Large} {Language} {Models} for {Requirements} {Question} {Answering} in {Industrial} {Aerospace} {Software}	2025	Ambiguo sin abstract
fu_cue_2025	Cue {RAG}: {Dynamic} multi-output cue memory under {H} framework for retrieval-augmented generation	2025	Ambiguo sin abstract
noauthor_ictir_2025	{ICTIR} 2025 - {Proceedings} of the 2025 {International} {ACM} {SIGIR} {Conference} on {Innovative} {Concepts} and {Theories} in {Information} {Retrieval}	2025	Ambiguo sin abstract
wallat_correctness_2025	Correctness is not {Faithfulness} in {Retrieval} {Augmented} {Generation} {Attributions}	2025	Ambiguo sin abstract
zhang_ask_2025	Ask and {Retrieve} {Knowledge}: {Towards} {Proactive} {Asking} with {Imperfect} {Information} in {Medical} {Multi}-turn {Dialogues}	2025	Ambiguo sin abstract
varga_inquiry_2025	Inquiry {Assistant} {Using} {LLM}-{Generated} {Knowledge} {Graphs}	2025	Ambiguo sin abstract
ross_rarr_2025	{RARR} {Unraveled}: {Component}-{Level} {Insights} into {Hallucination} {Detection} and {Mitigation}	2025	Ambiguo sin abstract
zhou_1st_2025	The 1st {NIP}@{IR} {Workshop} on {New} {Interaction} {Paradigms} for {Information} {Retrieval} in the {Era} of {Generative} {AI}	2025	Ambiguo sin abstract
deng_unveiling_2025	Unveiling {Knowledge} {Boundary} of {Large} {Language} {Models} for {Trustworthy} {Information} {Access}	2025	Ambiguo sin abstract
tang_boosting_2025	Boosting {Retrieval}-{Augmented} {Generation} with {Generation}-{Augmented} {Retrieval}: {A} {Co}-{Training} {Approach}	2025	Ambiguo sin abstract
abbasiantaeb_conversational_2025	Conversational {Gold}: {Evaluating} {Personalized} {Conversational} {Search} {System} {Using} {Gold} {Nuggets}	2025	Ambiguo sin abstract
cui_cirag_2025	{CIRAG}: {Retrieval}-{Augmented} {Language} {Model} with {Collective} {Intelligence}	2025	Ambiguo sin abstract
zhai_information_2025	Information {Retrieval} for {Artificial} {General} {Intelligence}: {A} {New} {Perspective} on {Information} {Retrieval} {Research}	2025	Ambiguo sin abstract
carmel_liverag_2025	The {LiveRAG} {Challenge} at {SIGIR} 2025	2025	Ambiguo sin abstract
feng_response_2025	Response {Quality} {Assessment} for {Retrieval}-{Augmented} {Generation} via {Conditional} {Conformal} {Factuality}	2025	Ambiguo sin abstract
xu_generative_2025	Generative artifcial intelligence-powered multi-agent paradigm for smart urban mobility: {Opportunities} and challenges for integrating large language models and retrieval-augmented generation with intelligent transportation systems	2025	Ambiguo sin abstract
alan_improving_2025	Improving {LLM} {Reliability} with {RAG} in {Religious} {Question}-{Answering}: {MufassirQAS}	2025	Ambiguo sin abstract
tayebi_arasteh_radiorag_2025	{RadioRAG}: {Online} {Retrieval}–{Augmented} {Generation} for {Radiology} {Question} {Answering}	2025	Ambiguo sin abstract
fink_retrieval-augmented_2025	Retrieval-{Augmented} {Generation} with {Large} {Language} {Models} in {Radiology}: {From} {Theory} to {Practice}	2025	Ambiguo sin abstract
rupanetti_industry_2025	An {Industry} {Application} of {Secure} {Augmentation} and {Gen}-{AI} for {Transforming} {Engineering} {Design} and {Manufacturing}	2025	Ambiguo sin abstract
lee_retrieval-augmented_2025	A {Retrieval}-{Augmented} {Generation} {System} for {Accurate} and {Contextual} {Historical} {Analysis}: {AI}-{Agent} for the {Annals} of the {Joseon} {Dynasty}	2025	Ambiguo sin abstract
bessa_performance_2025	Performance {Comparison} of {Large} {Language} {Models} on {Brazil}’s {Medical} {Revalidation} {Exam} for {Foreign}-{Trained} {Graduates}	2025	Ambiguo sin abstract
dong_syract_2025	{SyRACT}: zero-shot biomedical document-level relation extraction with synergistic {RAG} and {CoT}	2025	Ambiguo sin abstract
wang_innovative_2025	An innovative {ESGH}-{RAG} module with {ChatGPT}-4o for automatic {ESG}-report generation	2025	Ambiguo sin abstract
ashwin_fake_2025	Fake it till you make it? {AI} hallucinations and ethical dilemmas in {Anesthesia} research and practice	2025	Ambiguo sin abstract
ozmen_development_2025	Development of a novel artificial intelligence clinical decision support tool for hand surgery: {HandRAG}	2025	Ambiguo sin abstract
guofeng_multimodal_2025	Multimodal large language model for wheat breeding: {A} new exploration of smart breeding	2025	Ambiguo sin abstract
reason_using_2025	Using {Generative} {Artificial} {Intelligence} in {Health} {Economics} and {Outcomes} {Research}: {A} {Primer} on {Techniques} and {Breakthroughs}	2025	Ambiguo sin abstract
sezgin_decoypot_2025	{DecoyPot}: {A} large language model-driven web {API} honeypot for realistic attacker engagement	2025	Ambiguo sin abstract
wellawatte_chemlit-qa_2025	{ChemLit}-{QA}: a human evaluated dataset for chemistry {RAG} tasks	2025	Ambiguo sin abstract
wu_mkgf_2025	{MKGF}: {A} multi-modal knowledge graph based {RAG} framework to enhance {LVLMs} for {Medical} visual question answering	2025	Ambiguo sin abstract
hou_applied_2025	Applied {Research} on an {Aircraft} {Maintenance} {Assistant} {Based} on a {Large} {Language} {Model}	2025	Ambiguo sin abstract
setlur_supporting_2025	Supporting {Human}-{Centric} {Data} {Exploration} {Through} {Semantics} and {Natural} {Language} {Interaction}	2025	Ambiguo sin abstract
mahapatra_-storage_2025	In-{Storage} {Acceleration} of {Retrieval} {Augmented} {Generation} as a {Service}	2025	Ambiguo sin abstract
hamed_knowledge_2025	From knowledge generation to knowledge verification: examining the biomedical generative capabilities of {ChatGPT}	2025	Ambiguo sin abstract
hou_geo-fub_2025	Geo-{FuB}: {A} method for constructing an {Operator}-{Function} knowledge base for geospatial code generation with large language models	2025	Ambiguo sin abstract
nazary_stealthy_2025	Stealthy {LLM}-{Driven} {Data} {Poisoning} {Attacks} {Against} {Embedding}-{Based} {Retrieval}-{Augmented} {Recommender} {Systems}	2025	Ambiguo sin abstract
ren_large_2025	Large language model for interpreting research policy using adaptive two-stage retrieval augmented fine-tuning method	2025	Ambiguo sin abstract
schaffer_multimodal_2025	Multimodal cell maps as a foundation for structural and functional genomics	2025	Ambiguo sin abstract
wang_improving_2025	Improving knowledge management in building engineering with hybrid retrieval-augmented generation framework	2025	Ambiguo sin abstract
choi_empowering_2025	Empowering {PET} imaging reporting with retrieval-augmented large language models and reading reports database: a pilot single center study	2025	Ambiguo sin abstract
pelletier_evidence-based_2025	Evidence-based {Knowledge} {Synthesis} and {Hypothesis} {Validation}: {Navigating} {Biomedical} {Knowledge} {Bases} via {Explainable} {AI} and {Agentic} {Systems}	2025	Ambiguo sin abstract
montenegro_what_2025	What {We} {Know} {About} the {Role} of {Large} {Language} {Models} for {Medical} {Synthetic} {Dataset} {Generation}	2025	Ambiguo sin abstract
gupta_pidqaquestion_2025	{PIDQA}—{Question} {Answering} on {Piping} and {Instrumentation} {Diagrams}	2025	Ambiguo sin abstract
li_combining_2025	Combining {Lexicon} {Definitions} and the {Retrieval}-{Augmented} {Generation} of a {Large} {Language} {Model} for the {Automatic} {Annotation} of {Ancient} {Chinese} {Poetry}	2025	Ambiguo sin abstract
sezgin_natural_2025	Natural {Language} {Interfaces} for {Structured} {Query} {Generation} in {IoD} {Platforms}	2025	Ambiguo sin abstract
wagenpfeil_multimedia_2025	Multimedia {Graph} {Codes} for {Fast} and {Semantic} {Retrieval}-{Augmented} {Generation}	2025	Ambiguo sin abstract
he_using_2025	Using {Large} {Language} {Models} for {Aerospace} {Code} {Generation}: {Methods}, {Benchmarks}, and {Potential} {Values}	2025	Ambiguo sin abstract
hu_combining_2025	Combining {Retrieval}-{Augmented} {Generation} and {Fine}-{Tuning} of {Large} {Language} {Models} to {Enhance} {Port} {Industry} {Question}-{Answering} {Systems}	2025	Ambiguo sin abstract
bevara_prospects_2025	Prospects of {Retrieval}-{Augmented} {Generation} ({RAG}) for {Academic} {Library} {Search} and {Retrieval}	2025	Ambiguo sin abstract
james_retrieval-augmented_2025	Retrieval-{Augmented} {Generation} to {Generate} {Knowledge} {Assets} and {Creation} of {Action} {Drivers}	2025	Ambiguo sin abstract
he_venous_2025	Venous {Thrombosis} {Risk} {Assessment} {Based} on {Retrieval}-{Augmented} {Large} {Language} {Models} and {Self}-{Validation}	2025	Ambiguo sin abstract
yang_review_2025	A review on synergizing knowledge graphs and large language models	2025	Ambiguo sin abstract
roll_augmenting_2025	Augmenting {Orbital} {Debris} {Identification} with {Neo4j}-{Enabled} {Graph}-{Based} {Retrieval}-{Augmented} {Generation} for {Multimodal} {Large} {Language} {Models}	2025	Ambiguo sin abstract
dorfner_evaluating_2025	Evaluating the effectiveness of biomedical fine-tuning for large language models on clinical tasks	2025	Ambiguo sin abstract
magesh_hallucination-free_2025	Hallucination-{Free}? {Assessing} the {Reliability} of {Leading} {AI} {Legal} {Research} {Tools}	2025	Ambiguo sin abstract
song_uragunified_2025	{URAG}:{Unified} {Retrieval}-{Augmented} {Generation}	2025	Ambiguo sin abstract
vaidyanathan_survival_2025	Survival {Analysis} for {Cancers} of the {Brain}, {CNS} and {Bone} using {Retrieval} {Augmented} {Generation} on the {SEER} {Database}	2025	Ambiguo sin abstract
noauthor_proceedings_2025	Proceedings of the 2025 {AAAI} {Spring} {Symposium} {Series}, {SSS} 2025	2025	Ambiguo sin abstract
fu_engineering_2025	Engineering the {Reproducible} {Literature} {Review} {Section} for {Scholarly} {Publications} and {Grant} {Applications}	2025	Ambiguo sin abstract
fuchs_practical_2025	Practical {Fact} {Checking} {System} for {LLMs}	2025	Ambiguo sin abstract
liang_kag_2025	{KAG}: {Boosting} {LLMs} in {Professional} {Domains} via {Knowledge} {Augmented} {Generation}	2025	Ambiguo sin abstract
jiao_retrieval_2025	Retrieval and {Structuring} {Augmented} {Generation} with {LLMs} for {Web} {Applications} ({Lecture}-{Style})	2025	Ambiguo sin abstract
bi_rbdq_2025	{RBDQ}: {A} {Reliable} {LLM}-based {Text}-to-{SQL} {System} for {Business} {Data} {Queries}	2025	Ambiguo sin abstract
mou_exploring_2025	Exploring the {Potential} of {Retrieval} {Augmented} {Generation} for {Question} {Answering} in {Radiology}: {Initial} {Findings} and {Future} {Directions}	2025	Ambiguo sin abstract
carvalho_towards_2025	Towards the {Application} of {GraphRAG} to {Network} {Security}	2025	Ambiguo sin abstract
bender_next_2025	Next {Sentence} {Prediction} with {BERT} as a {Dynamic} {Chunking} {Mechanism} for {Retrieval}-{Augmented} {Generation} {Systems}	2025	Ambiguo sin abstract
gao_optimized_2025	Optimized {Individual} {Modules} in {Retrieval} {Augmented} {Generation} in {Concrete} {Scenarios}	2025	Ambiguo sin abstract
yang_explaingen_2025	{ExplainGen}: a {Human}-{Centered} {LLM} {Assistant} for {Combating} {Misinformation}	2025	Ambiguo sin abstract
wu_diagnosis_2025	Diagnosis assistant for liver cancer utilizing a large language model with three types of knowledge	2025	Ambiguo sin abstract
chen_self-improving_2025	A {Self}-{Improving}, {RAG}-{Enhanced} {Framework} for {Automatic} {Knowledge} {Graph} {Construction} from {Climate} {Event} {News}	2025	Ambiguo sin abstract
weinert_enhancing_2025	Enhancing {Large} {Language} {Models} with {Retrieval}-{Augmented} {Generation}: {A} {Radiology}-{Specific} {Approach}	2025	Ambiguo sin abstract
hao_advancing_2025	Advancing {Large} {Language} {Models} with {Enhanced} {Retrieval}-{Augmented} {Generation}: {Evidence} from {Biological} {UAV} {Swarm} {Control}	2025	Ambiguo sin abstract
wang_artificial_2025	Artificial {General} {Intelligence} ({AGI}) {Applications} and {Prospect} in {Oil} and {Gas} {Reservoir} {Development}	2025	Ambiguo sin abstract
yao_ai-powered_2025	{AI}-{Powered} {System} to {Facilitate} {Personalized} {Adaptive} {Learning} in {Digital} {Transformation}	2025	Ambiguo sin abstract
pickard_automatic_2025	Automatic biomarker discovery and enrichment with {BRAD}	2025	Ambiguo sin abstract
ben_amor_instruct--sparql_2025	Instruct-to-{SPARQL}: {A} text-to-{SPARQL} dataset for training {SPARQL} {Agents}	2025	Ambiguo sin abstract
novin_tool_2025	A {Tool} for {Researching} how {AI} {Affects} {Information} {Seeking}	2025	Ambiguo sin abstract
liu_mask-based_2025	Mask-based {Membership} {Inference} {Attacks} for {Retrieval}-{Augmented} {Generation}	2025	Ambiguo sin abstract
wang_colacare_2025	{ColaCare}: {Enhancing} {Electronic} {Health} {Record} {Modeling} through {Large} {Language} {Model}-{Driven} {Multi}-{Agent} {Collaboration}	2025	Ambiguo sin abstract
tan_paths-over-graph_2025	Paths-over-{Graph}: {Knowledge} {Graph} {Empowered} {Large} {Language} {Model} {Reasoning}	2025	Ambiguo sin abstract
hanafi_creating_2025	Creating {Conversational} {Datasets} for {Retrieval}-{Augmented} {Generation} {Applications} is {Hard}: {Challenges} \& {Research} {Opportunities}	2025	Ambiguo sin abstract
ko_legolas_2025	{LEGOLAS}: {Learning} \& {Enhancing} {Golf} {Skills} through {LLM}-{Augmented} {System}	2025	Ambiguo sin abstract
kruk_banglassist_2025	{BanglAssist}: {A} {Bengali}-{English} {Generative} {AI} {Chatbot} for {Code}-{Switching} and {Dialect}-{Handling} in {Customer} {Service}	2025	Ambiguo sin abstract
li_omniquery_2025	{OmniQuery}: {Contextually} {Augmenting} {Captured} {Multimodal} {Memories} to {Enable} {Personal} {Question} {Answering}	2025	Ambiguo sin abstract
wang_social-rag_2025	Social-{RAG}: {Retrieving} from {Group} {Interactions} to {Socially} {Ground} {AI} {Generation}	2025	Ambiguo sin abstract
tadaga_gangadhar_comparative_2025	Comparative {Analysis} of {Large} {Language} {Models} {Fine}-tuned on a {Singular} {Dataset}	2025	Ambiguo sin abstract
liang_fast_2025	Fast {Think}-on-{Graph}: {Wider}, {Deeper} and {Faster} {Reasoning} of {Large} {Language} {Model} on {Knowledge} {Graph}	2025	Ambiguo sin abstract
long_retrieval-augmented_2025	Retrieval-{Augmented} {Visual} {Question} {Answering} via {Built}-in {Autoregressive} {Search} {Engines}	2025	Ambiguo sin abstract
lin_explore_2025	Explore {What} {LLM} {Does} {Not} {Know} in {Complex} {Question} {Answering}	2025	Ambiguo sin abstract
zhang_knowpo_2025	{KnowPO}: {Knowledge}-{Aware} {Preference} {Optimization} for {Controllable} {Knowledge} {Selection} in {Retrieval}-{Augmented} {Language} {Models}	2025	Ambiguo sin abstract
zhu_radio_2025	{RaDIO}: {Real}-{Time} {Hallucination} {Detection} with {Contextual} {Index} {Optimized} {Query} {Formulation} for {Dynamic} {Retrieval} {Augmented} {Generation}	2025	Ambiguo sin abstract
wang_maferw_2025	{MaFeRw}: {Query} {Rewriting} with {Multi}-{Aspect} {Feedbacks} for {Retrieval}-{Augmented} {Large} {Language} {Models}	2025	Ambiguo sin abstract
zhang_ratt_2025	{RATT}: {A} {Thought} {Structure} for {Coherent} and {Correct} {LLM} {Reasoning}	2025	Ambiguo sin abstract
hong_innovative_2025	{INNOVATIVE} {APPLICATIONS} {OF} {RAG}-{ENHANCED} {SMALL} {LLM} {FOR} {CLOSED}-{DOMAIN} {Q}\&{A}	2025	Ambiguo sin abstract
soman_human_2025	Human guided empathetic {AI} agent for mental health support leveraging reinforcement learning-enhanced retrieval-augmented generation	2025	Ambiguo sin abstract
tozuka_application_2025	Application of {NotebookLM}, a large language model with retrieval-augmented generation, for lung cancer staging	2025	Ambiguo sin abstract
kim_llm-based_2025	{LLM}-{Based} {Response} {Generation} for {Korean} {Adolescents}: {A} {Study} {Using} the {NAVER} {Knowledge} {iN} {Q}\&{A} {Dataset} with {RAG}	2025	Ambiguo sin abstract
farias_chatbot_2025	Chatbot {Based} on {Large} {Language} {Model} to {Improve} {Adherence} to {Exercise}-{Based} {Treatment} in {People} with {Knee} {Osteoarthritis}: {System} {Development}	2025	Ambiguo sin abstract
lee_developing_2025	Developing a computer-based tutor utilizing {Generative} {Artificial} {Intelligence} ({GAI}) and {Retrieval}-{Augmented} {Generation} ({RAG})	2025	Ambiguo sin abstract
son_advancing_2025	Advancing {Multimodal} {Large} {Language} {Models}: {Optimizing} {Prompt} {Engineering} {Strategies} for {Enhanced} {Performance}	2025	Ambiguo sin abstract
shin_thyro-genai_2025	Thyro-{GenAI}: {A} {Chatbot} {Using} {Retrieval}-{Augmented} {Generative} {Models} for {Personalized} {Thyroid} {Disease} {Management}	2025	Ambiguo sin abstract
mitchell_using_2025	Using artificial intelligence tools to automate data extraction for living evidence syntheses	2025	Ambiguo sin abstract
ilyas_enhancing_2025	Enhancing the {RAG} pipeline through advanced optimization techniques	2025	Ambiguo sin abstract
mukhopadhyay_designing_2025	Designing {Conversational} {Search} for {Libraries}: {Retrieval} {Augmented} {Generation} through {Open} {Source} {Large} {Language} {Models}	2025	Ambiguo sin abstract
williams_ai_2025	{AI} in veterinary medicine: where to start and what's new?	2025	Ambiguo sin abstract
datta_raging_2025	Raging against the literature: {Llm}-powered dataset mention extraction	2025	Ambiguo sin abstract
zhang_exploring_2025	Exploring efficient optimization techniques in online retrieval-augmented generation application	2025	Ambiguo sin abstract
susnjak_automating_2025	Automating {Research} {Synthesis} with {Domain}-{Specific} {Large} {Language} {Model} {Fine}-{Tuning}	2025	Ambiguo sin abstract
bordino_uniask_2025	{UniAsk}: {AI}-powered search for banking knowledge bases	2025	Ambiguo sin abstract
sokol_ventana_2025	Ventana a la {Verdad} ({Window} to the {Truth}): {A} {Chatbot} {Application} for {Navigating} {The} {Colombian} {Truth} {Commission}'s {Archives}	2025	Ambiguo sin abstract
rastogi_specialtyscribe_2025	{SpecialtyScribe}: {Enhancing} {SOAP} note {Scribing} for {Medical} {Specialties} using {LLMs}	2025	Ambiguo sin abstract
liang_efficient_2025	Efficient and verifiable responses using {Retrieval} {Augmented} {Generation} ({RAG})	2025	Ambiguo sin abstract
kim_development_2025	Development of an {Automated} {Construction} {Contract} {Review} {Framework} {Using} {Large} {Language} {Model} and {Domain} {Knowledge}	2025	Ambiguo sin abstract
sharma_forensicllm_2025	{ForensicLLM}: {A} local large language model for digital forensics	2025	Ambiguo sin abstract
perkins_retrieval-augmented_2025	Retrieval-augmented generation salvages poor performance from large language models in answering microbiology-specific multiple-choice questions	2025	Ambiguo sin abstract
zhang_hallucination_2025	Hallucination {Mitigation} for {Retrieval}-{Augmented} {Large} {Language} {Models}: {A} {Review}	2025	Ambiguo sin abstract
hou_construction_2025	Construction and {Application} of {Traffic} {Accident} {Knowledge} {Graph} {Based} on {LLM}	2025	Ambiguo sin abstract
ma_sdd-lawllm_2025	{SDD}-{LawLLM}: {Advancing} {Intelligent} {Legal} {Systems} {Through} {Synthetic} {Data}-{Driven} {Fine}-{Tuning} of {Large} {Language} {Models}	2025	Ambiguo sin abstract
lakehal_cores_2025	{CORES}: {Context}-{Aware} {Emotion}-{Driven} {Recommendation} {System}-{Based} {LLM} to {Improve} {Virtual} {Shopping} {Experiences}	2025	Ambiguo sin abstract
son_optimizing_2025	Optimizing {Large} {Language} {Models}: {A} {Deep} {Dive} into {Effective} {Prompt} {Engineering} {Techniques}	2025	Ambiguo sin abstract
matsumoto_escargot_2025	{ESCARGOT}: an {AI} agent leveraging large language models, dynamic graph of thoughts, and biomedical knowledge graphs for enhanced reasoning	2025	Ambiguo sin abstract
fuellen_validation_2025	Validation requirements for {AI}-based intervention-evaluation in aging and longevity research and practice	2025	Ambiguo sin abstract
uhm_effectiveness_2025	Effectiveness of retrieval augmented generation-based large language models for generating construction safety information	2025	Ambiguo sin abstract
liu_optimizing_2025	Optimizing {RAG} {Techniques} for {Automotive} {Industry} {PDF} {Chatbots}: {A} {Case} {Study} with {Locally} {Deployed} {Ollama} {ModelsOptimizing} {RAG} {Techniques} {Based} on {Locally} {Deployed} {Ollama} {ModelsA} {Case} {Study} with {Locally} {Deployed} {Ollama} {Models}	2025	Ambiguo sin abstract
chen_using_2025	Using {Large} {Language} {Models} to {Assist} {Antimicrobial} {Resistance} {Policy} {Development}: {Integrating} the {Environment} into {Health} {Protection} {Planning}	2025	Ambiguo sin abstract
rosenthal_clapnq_2025	{CLAPnq}: {Cohesive} {Long}-form {Answers} from {Passages} in {Natural} {Questions} for {RAG} systems	2025	Ambiguo sin abstract
diers-lawson_hallucination_2025	Hallucination or vision? {Establishing} reliability and validity of {AI}-based qualitative analysis of the unified model of activism in the {Scottish} independence {Twitter} debate	2025	Ambiguo sin abstract
sastre_derivation_2025	Derivation {Prompting}: {A} {Logic}-{Based} {Method} for {Improving} {Retrieval}-{Augmented} {Generation}	2025	Ambiguo sin abstract
alkouz_ukrag_2025	{UKRAG}: {A} {Unified} {Knowledge} {Graph} to {Enhance} {Retrieval} {Augmented} {Generation} {Performance}	2025	Ambiguo sin abstract
amazou_accurate_2025	Accurate {AI} {Assistance} in {Contract} {Law} {Using} {Retrieval}-{Augmented} {Generation} to {Advance} {Legal} {Technology}	2025	Ambiguo sin abstract
khalila_investigating_2025	Investigating {Retrieval}-{Augmented} {Generation} in {Quranic} {Studies}: {A} {Study} of 13 {Open}-{Source} {Large} {Language} {Models}	2025	Ambiguo sin abstract
anichkov_retrieval_2025	Retrieval {Poisoning} {Attacks} {Based} on {Prompt} {Injections} into {Retrieval}-{Augmented} {Generation} {Systems} that {Store} {Generated} {Responses}	2025	Ambiguo sin abstract
berman_retrieval_2025	Retrieval {Augmented} {Therapy} {Suggestion} for {Molecular} {Tumor} {Boards}: {Algorithmic} {Development} and {Validation} {Study}	2025	Ambiguo sin abstract
qian_capacity_2025	On the {Capacity} of {Citation} {Generation} by {Large} {Language} {Models}	2025	Ambiguo sin abstract
poretsky_assessing_2025	Assessing the performance of generative artificial intelligence in retrieving information against manually curated genetic and genomic data	2025	Ambiguo sin abstract
noauthor_icsob-c_2025	{ICSOB}-{C} 2024 - {Companion} {Proceedings} of the 15th {International} {Conference} on {Software} {Business} ({PhD} {Retreat}, {Posters} and {Demos} {Track})	2025	Ambiguo sin abstract
wang_richrag_2025	{RichRAG}: {Crafting} {Rich} {Responses} for {Multi}-faceted {Queries} in {Retrieval}-{Augmented} {Generation}	2025	Ambiguo sin abstract
zhang_wikigenbench_2025	{WIKIGENBENCH}: {Exploring} {Full}-length {Wikipedia} {Generation} under {Real}-{World} {Scenario}	2025	Ambiguo sin abstract
muller_grouse_2025	{GroUSE}: {A} {Benchmark} to {Evaluate} {Evaluators} in {Grounded} {Question} {Answering}	2025	Ambiguo sin abstract
shandilya_boosting_2025	Boosting the {Capabilities} of {Compact} {Models} in {Low}-{Data} {Contexts} with {Large} {Language} {Models} and {Retrieval}-{Augmented} {Generation}	2025	Ambiguo sin abstract
ok_synthetic_2025	Synthetic {Paths} to {Integral} {Truth}: {Mitigating} {Hallucinations} {Caused} by {Confirmation} {Bias} with {Synthetic} {Data}	2025	Ambiguo sin abstract
wang_llms_2025	{LLMs} {Know} {What} {They} {Need}: {Leveraging} a {Missing} {Information} {Guided} {Framework} to {Empower} {Retrieval}-{Augmented} {Generation}	2025	Ambiguo sin abstract
noauthor_workshop_2025	Workshop on {Generative} {AI} and {Knowledge} {Graphs}, {GenAIK} 2025 - {Proceedings} of the {Workshop}	2025	Ambiguo sin abstract
mahalingam_sketch_2025	{SKETCH}: {Structured} {Knowledge} {Enhanced} {Text} {Comprehension} for {Holistic} {Retrieval}	2025	Ambiguo sin abstract
cinquin_steering_2025	Steering veridical large language model analyses by correcting and enriching generated database queries: first steps toward {ChatGPT} bioinformatics	2025	Ambiguo sin abstract
setyawan_soekamto_queries_2025	From {Queries} to {Courses}: {SKYRAG}'s {Revolution} in {Learning} {Path} {Generation} via {Keyword}-{Based} {Document} {Retrieval}	2025	Ambiguo sin abstract
lane_mitigating_2025	Mitigating risks, embracing potential: a framework for integrating generative artificial intelligence in geographical and environmental education	2025	Ambiguo sin abstract
ai_foundations_2025	Foundations of {Generative} {Information} {Retrieval}	2025	Ambiguo sin abstract
meng_using_2025	Using the {Retrieval}-{Augmented} {Generation} to {Improve} the {Question}-{Answering} {System} in {Human} {Health} {Risk} {Assessment}: {The} {Development} and {Application}	2025	Ambiguo sin abstract
thetbanthad_application_2025	Application of {Generative} {Artificial} {Intelligence} {Models} for {Accurate} {Prescription} {Label} {Identification} and {Information} {Retrieval} for the {Elderly} in {Northern} {East} of {Thailand}	2025	Ambiguo sin abstract
dayarathne_comparing_2025	Comparing the {Performance} of {LLMs} in {RAG}-{Based} {Question}-{Answering}: {A} {Case} {Study} in {Computer} {Science} {Literature}	2025	Ambiguo sin abstract
das_two-layer_2025	Two-{Layer} {Retrieval}-{Augmented} {Generation} {Framework} for {Low}-{Resource} {Medical} {Question} {Answering} {Using} {Reddit} {Data}: {Proof}-of-{Concept} {Study}	2025	Ambiguo sin abstract
kehan_crp-rag_2025	{CRP}-{RAG}: {A} {Retrieval}-{Augmented} {Generation} {Framework} for {Supporting} {Complex} {Logical} {Reasoning} and {Knowledge} {Planning}	2025	Ambiguo sin abstract
labib_leveraging_2025	Leveraging {Multimodal} {Large} {Language} {Models} for {Enhanced} {Learning} and {Application} in {Building} {Energy} {Modeling}	2025	Ambiguo sin abstract
wang_using_2025	Using {Large} {Language} {Models} for {Efficient} {Cancer} {Registry} {Coding} in the {Real} {Hospital} {Setting}: {A} {Feasibility} {Study}	2025	Ambiguo sin abstract
guan__2025	: {A} {Voting}-{Based} {Paradigm} for {Enhancing} {Retrieval} {Augmented} {Generation}	2025	Ambiguo sin abstract
agater_slango_2025	{SLANGO} - {The} {Initial} {Blueprint} of {Privacy}-{Oriented} {Legal} {Query} {Assistance}: {Exploring} the {Potential} of {Retrieval}-{Augmented} {Generation} for {German} {Law} {Using} {SPR}	2025	Ambiguo sin abstract
gupta_refine_2025	{REFINE} on {Scarce} {Data}: {Retrieval} {Enhancement} {Through} {Fine}-{Tuning} via {Model} {Fusion} of {Embedding} {Models}	2025	Ambiguo sin abstract
nouzri_beyond_2025	Beyond {Chatbots}: {Enhancing} {Luxembourgish} {Language} {Learning} {Through} {Multi}-agent {Systems} and {Large} {Language} {Model}	2025	Ambiguo sin abstract
liu_retrieval_2025	Retrieval {Augmented} {Tree} of {Thoughts}	2025	Ambiguo sin abstract
noauthor_43rd_2025	43rd {International} {Conference} on {Conceptual} {Modeling}, {ER} 2024	2025	Ambiguo sin abstract
papadopoulos_notitle_2025		2025	Ambiguo sin abstract
djoudi_notitle_2025		2025	Ambiguo sin abstract
null_notitle_2025-2		2025	Ambiguo sin abstract
borazio_notitle_2025		2025	Ambiguo sin abstract
kim_notitle_2025		2025	Ambiguo sin abstract
null_notitle_2025-3		2025	Ambiguo sin abstract
wu_notitle_2025		2025	Ambiguo sin abstract
jin_risk_2025	Risk {Identification} {Method} for {Electric} {Power} {Customer} {Service} {Based} on {Fine}-{Tuning} {Language} {Model}	2025	Ambiguo sin abstract
wang_multi-agent_2025	Multi-{Agent} {RAG}-{Based} {Framework} for {Personalized} {Interaction} with {Large} {Language} {Models}	2025	Ambiguo sin abstract
yahia_empathetic_2025	Empathetic {AI} for {Mental} {Health}: {A} {Comparative} {Study} of {Retrieval}-{Augmented} {Language} {Models} in {CBT} {Applications}	2025	Ambiguo sin abstract
sharma_mitigating_2025	Mitigating {Hallucination} - {ZeroG}: {An} {Advanced} {Knowledge} {Management} {Engine}	2025	Ambiguo sin abstract
ekin_red-teaming_2025	Red-{Teaming} for {Health} {Care} {Fraud} {Detection}: {A} {RAG}-{Based} {AI} {Approach}	2025	Ambiguo sin abstract
bhagwat_nyai_2025	{NyAI} {Saathi} - {Legal} {Research} {Tool} leveraging {GenAI} ({RAG})	2025	Ambiguo sin abstract
jing_kg-enhanced_2025	{KG}-{Enhanced} {Synthetic} {Report} {Generation} for {Addressing} {Class} {Imbalance} in {Aviation} {Safety} {Data}	2025	Ambiguo sin abstract
rahman_retrieval_2025	Retrieval {Augmented} {Generation} {Based} {Question} {Answering} {System} on {Policy} {Documents}	2025	Ambiguo sin abstract
tampubolon_retrieval_2025	Retrieval {Augmented} {Generation} with {Synergizing} {Reasoning} and {Acting} {Prompt} {Engineering} for {Indonesian} {Open}-{Domain} {Question} {Answering}	2025	Ambiguo sin abstract
mohsin_retrieval_2025	Retrieval {Augmented} {Generation} with {Multi}-{Modal} {LLM} {Framework} for {Wireless} {Environments}	2025	Ambiguo sin abstract
hamayat_seebot_2025	{SEEBot}: {Leveraging} {Open}-{Source} {LLMs} and {RAG} for {Secure} and {Economical} {Enterprise} {Chatbots}	2025	Ambiguo sin abstract
kukreja_performance_2025	Performance {Enhancement} of {Agentic} {Retrieval} {Augmented} {Generation} {Using} {Relevance} {Generative} {Answering}	2025	Ambiguo sin abstract
al_atraqchi_large_2025	Large {Language} {Models} and {Talent} {Management}: {Developing} {RAG} {Model} in {Healthcare}	2025	Ambiguo sin abstract
ding_sc-rag-cot_2025	{SC}-{RAG}-{CoT}: {An} {Optimization} {Method} for {Robotic} {Instruction} {Generation}	2025	Ambiguo sin abstract
mahmoud_o-ran_2025	O-{RAN} {Assistant}: {Leveraging} {RAG} for {Installation}, {Configuration}, and {Information} for {O}-{RAN}	2025	Ambiguo sin abstract
parameswaran_evaluating_2025	Evaluating {Large} {Language} {Models} and {Retrieval}-{Augmented} {Generation} {Enhancement} for {Delivering} {Guideline}-{Adherent} {Nutrition} {Information} for {Cardiovascular} {Disease} {Prevention}: {Cross}-{Sectional} {Study}	2025	Ambiguo sin abstract
nishisako_reducing_2025	Reducing {Hallucinations} and {Trade}-{Offs} in {Responses} in {Generative} {AI} {Chatbots} for {Cancer} {Information}: {Development} and {Evaluation} {Study}	2025	Ambiguo sin abstract
alenjareghi_llm-driven_2025	{LLM}-{Driven} {FMEA} for {Safe} {Human}-{Robot} {Collaboration} in {Disassembly}	2025	Ambiguo sin abstract
zhao_knowledge_2025	Knowledge {Retrieval} {Enhancement} for {Power} {System} {Based} on {Adaptive} {Dynamic} {Text} {Segmentation} and {Hierarchical} {Multi}-{Query}	2025	Ambiguo sin abstract
wang_ms-rag_2025	{MS}-{RAG}: {A} {Multimodal} {Retrieval}-{Augmented} {Framework} for {Digital} {Twins} with {Knowledge} {Graph} {Reasoning}	2025	Ambiguo sin abstract
ocker_grounded_2025	A {Grounded} {Memory} {System} {For} {Smart} {Personal} {Assistants}	2025	Ambiguo sin abstract
ongris_frog_2025	{FrOG}: {Framework} of {Open} {GraphRAG}	2025	Ambiguo sin abstract
agrawal_algoace_2025	{AlgoAce}: {Retrieval}-{Augmented} {Generation} for {Assistance} in {Competitive} {Programming}	2025	Ambiguo sin abstract
majumder_development_2025	Development and {Evaluation} of a {Retrieval}-{Augmented} {Generation} {Tool} for {Creating} {SAPPhIRE} {Models} of {Artificial} {Systems}	2025	Ambiguo sin abstract
somasundharam_llm_2025	{LLM} {Powered} {News} {Research} {Tool} for {Insight} {Extraction}	2025	Ambiguo sin abstract
rajbhar_aiced-prep_2025	{AIced}-{Prep} -{AI} {Based} {Mock} {Interview} {Evaluator}	2025	Ambiguo sin abstract
lee_less_2025	Less is {Better}: {A} {Comparative} {Analysis} of {Guidance} {Methods} for {Long}-{Context} {Window}-{Based} {Legal} {Interpretation}	2025	Ambiguo sin abstract
mikulic_integrating_2025	Integrating {External} {Knowledge} with {LLMs}: {A} {Systematic} {Review} of {RAG} {Approaches}	2025	Ambiguo sin abstract
sonawane_implementation_2025	Implementation of an {Interactive} {Query} {System} {Using} {Nomic} {Text} {Embed}, {DeepSeek} {R1} 1.{5B}, and {Cosine} {Similarity} rankers	2025	Ambiguo sin abstract
mashnoor_timelyhls_2025	{TimelyHLS}: {LLM}-{Based} {Timing}-{Aware} and {Architecture}-{Specific} {FPGA} {HLS} {Optimization}	2025	Ambiguo sin abstract
pinna_ai-driven_2025	{AI}-{Driven} {Differential} {Diagnosis}: {Leveraging} {RAG} and {LLMs} in {Intelligent} {Healthcare} {Systems}	2025	Ambiguo sin abstract
garcia_df-rag_2025	{DF}-{RAG}: {A} {Dual} {Federated} {Retrieval}-{Augmented} {Generation} {Framework} for {Collaborative} {Medical} {AI}	2025	Ambiguo sin abstract
min_verification_2025	Verification and {Validation} of {LLM}-{RAG} for {Industrial} {Automation}	2025	Ambiguo sin abstract
noauthor_proceedings_2025-1	Proceedings - 19th {IEEE} {International} {Conference} on {Service}-{Oriented} {System} {Engineering}, {SOSE} 2025	2025	Ambiguo sin abstract
yang_chain--summary_2025	Chain-of-{Summary}: {An} {Efficient} {Multi}-{Clustering} {Framework} for {Hierarchical} {Abstraction}	2025	Ambiguo sin abstract
vungarala_tpu-gen_2025	{TPU}-{Gen}: {LLM}-{Driven} {Custom} {Tensor} {Processing} {Unit} {Generator}	2025	Ambiguo sin abstract
tang_hivegen_2025	{HiVeGen} - {Hierarchical} {LLM}-based {Verilog} {Generation} for {Scalable} {Chip} {Design}	2025	Ambiguo sin abstract
ma_role_2025	The {Role} {Evolution} of {KGs} in {Synthesizing} with {LLMs}: {From} {Background} {Knowledge} to {Joint} {Reasoning}	2025	Ambiguo sin abstract
wan_facilitating_2025	Facilitating {Design} for {Additive} {Manufacturing} with {KG}-based {Retrieval}-{Augmented} {Generation}	2025	Ambiguo sin abstract
ugur_guided_2025	Guided {Decoding} and {Its} {Critical} {Role} in {Retrieval}-{Augmented} {Generation}	2025	Ambiguo sin abstract
liu_enhancing_2025	Enhancing {Large} {Language} {Models} with {Pseudo}- and {Multisource}-{Knowledge} {Graphs} for {Open}-ended {Question} {Answering}	2025	Ambiguo sin abstract
cheung_hallucination_2025	Hallucination {Detection} with {Small} {Language} {Models}	2025	Ambiguo sin abstract
chen_adaptive_2025	Adaptive {Retrieval}-{Augmented} {Embodied} {Intelligence} {RAG} {Reasoning} {Framework}	2025	Ambiguo sin abstract
donvir_leveraging_2025	Leveraging {RAG} for {Enhanced} {Business} {Intelligence} with {Local} {LLMs}	2025	Ambiguo sin abstract
sha_leveraging_2025	Leveraging {Retrieval}-{Augmented} {Large} {Language} {Models} for {Dietary} {Recommendations} {With} {Traditional} {Chinese} {Medicine}’s {Medicine} {Food} {Homology}: {Algorithm} {Development} and {Validation}	2025	Ambiguo sin abstract
hedi_artificial_2025	Artificial {Intelligence} {Agents} for {Personalized} {Adaptive} {Learning}	2025	Ambiguo sin abstract
vach_evaluating_2025	Evaluating {Retrieval} {Augmented} {Generation}-enhanced {Large} {Language} {Models} for {Question} {Answering} {On} {German} {Neurovascular} {Guidelines}	2025	Ambiguo sin abstract
vieira-vieira_data_2025	From data silos to insights: the {PRINCE} multi-agent knowledge engine for preclinical drug development	2025	Ambiguo sin abstract
yildirim_rag-based_2025	A {RAG}-{Based} {Automotive} {Sector} {AI} {Assistant} for {Enhanced} {Information} {Retrieval}	2025	Ambiguo sin abstract
wang_hiyo-encoder_2025	{HIYO}-{Encoder}: {A} dual-retrieval model based on expanded question generation for addressing hallucinations in question answering	2025	Ambiguo sin abstract
rui_chatcl_2025	{ChaTCL}: {LLM}-{Based} {Multi}-{Agent} {RAG} {Framework} for {TCL} {Script} {Generation}	2025	Ambiguo sin abstract
wiest_large_2025	Large language models for clinical decision support in gastroenterology and hepatology	2025	Ambiguo sin abstract
belkhouribchia_large_2025	Large language models in clinical nutrition: an overview of its applications, capabilities, limitations, and potential future prospects	2025	Ambiguo sin abstract
wright_using_2025	Using {Digital} {Textbook} and {Classroom} {Data} to {Explore} {Multimodal} ({Audio}, {Visual}, \& {Textual}) {LLM} {Retrieval} {Techniques}	2025	Ambiguo sin abstract
kamra_evaluating_2025	Evaluating {Reinforcement} {Learning} {Based} {Models} for {Test} {Time} {Enhancement} in {RAG}	2025	Ambiguo sin abstract
ngandu_juro_2025	Juro: {A} {Retrieval}-{Augmented} {Generation} {AI} {Chatbot} for {Enhancing} {Legal} {Information} {Access} in {Resource}-{Constrained} {Settings}	2025	Ambiguo sin abstract
kim_geographic_2025	Geographic {Limitations} of {Generative} {AI} {Models}	2025	Ambiguo sin abstract
blanchard_making_2025	Making {Generative} {AI} {Hallucinations} {Useful} by {Reassessing} the {Troublemaker} {Agent} {Strategy}	2025	Ambiguo sin abstract
qi_p-lrr_2025	P-{LRR}: {A} {LLM}-{Enhanced} {Retrieval} and {Reranking} {Framework} for {Policy} {Domain}	2025	Ambiguo sin abstract
cole_towards_2025	Towards {AI}-augmented sustainability assessments: integrating large language models in the case of product social life cycle assessment	2025	Ambiguo sin abstract
wang_visualrag_2025	{VisualRAG}: {Knowledge}-{Guided} {Retrieval} {Augmentation} for {Image}-{Text} {Matching}	2025	Ambiguo sin abstract
zhang_leveraging_2025-1	Leveraging {Large} {Language} {Models} for {Personalized} {Parkinson}'s {Disease} {Treatment}	2025	Ambiguo sin abstract
jiang_multi_semantic_2025	Multi\_semantic {RAG}: {What}’s not {Important} is {Important}	2025	Ambiguo sin abstract
li_eduragrag_2025	{EduRAG}:{A} {RAG} {Framework} for {Academic} {Expert} {Recommendation}	2025	Ambiguo sin abstract
sonkar_dynamic_2025	Dynamic {Query} {Handling} with {RAG} {Fusion} for {PDF}-{Based} {Knowledge} {Retrieval} {Systems}	2025	Ambiguo sin abstract
zhai_law_2025	Law {GraphRAG}: {An} {Advanced} {Legal} {Question}-{Answering} {System}	2025	Ambiguo sin abstract
zhang_corag_2025	{CoRAG}: {Enhancing} {Retrieval}-{Augmented} {Generation} with {Coreference} {Resolution}	2025	Ambiguo sin abstract
xu_using_2025	Using {Clinical} {Guidelines}, domain ontology, and {LLMs} for {Personalized} {Leukemia} {Treatment} {Recommendations}	2025	Ambiguo sin abstract
li_grag-zre_2025	{GRAG}-{ZRE}: {Graph} {Retrieval}-{Augmented} {Generation} for {Zero}-{Shot} {Relation} {Extraction} in {Domain}-{Sensitive} {Scenarios}	2025	Ambiguo sin abstract
fan_why_2025	Why {Did} the {AI} {Suggest} {That}? {Designing} an {Explainable} {Educational} {Counseling} {System}	2025	Ambiguo sin abstract
patel_agentic_2025	{AGENTIC} {RETRIEVAL}-{AUGMENTED} {GENERATION} {FOR} {FINANCIAL} {QA}: {A} {SINGLESTORE} {OPTIMIZATION} {APPROACH}	2025	Ambiguo sin abstract
kumawat_sh-rag_2025	{SH}-{RAG} ({SELF}-{HEALING} {RETRIEVAL} {AUGMENTED} {GENERATION}): {A} {SELF}-{CORRECTING} {RAG} {FRAMEWORK} {FOR} {LARGE} {LANGUAGE} {MODELS}	2025	Ambiguo sin abstract
zhao_slideitright_2025	{SlideItRight}: {Using} {AI} to {Find} {Relevant} {Slides} and {Provide} {Feedback} for {Open}-{Ended} {Questions}	2025	Ambiguo sin abstract
shimada_leveraging_2025	Leveraging {Lecture} and {Student} {Knowledge} for {Improved} {AI} {Chatbot} {Responses} in {Education}	2025	Ambiguo sin abstract
noauthor_2025_2025	2025 11th {International} {Conference} on {Web} {Research}, {ICWR} 2025	2025	Ambiguo sin abstract
guo_root_2025	Root {Cause} {Analysis} of {Power} {Grid} {5G} {Network} {Faults} {Based} on {Large} {Language} {Model}	2025	Ambiguo sin abstract
guan_external_2025	From {External} {Similarity} to {Internal} {Consistency}: {An} {Enhanced} {Retrieval}-{Based} {Method} for {LLMs}' {Reliable} {Content} {Generation}	2025	Ambiguo sin abstract
amo-filva_expressing_2025	Expressing {Educational} {Content} with {Extensive} {Language} {Models}: {A} {Question} of {Context}	2025	Ambiguo sin abstract
arjona-giner_multiagent_2025	Multiagent {Systems} for {Educational} {Transformation}: {A} {Swarm} of {Intelligent} {Personal} {Assistants}	2025	Ambiguo sin abstract
bu_rb-rag_2025	{RB}-{RAG}: {Intelligent} {Question} {Answering} {System} of {Rock} {Burst} {Knowledge} {Based} on {Retrieval}-{Augmented} {Generation}	2025	Ambiguo sin abstract
abtahi_augmenting_2025	Augmenting {Large} {Language} {Models} with {Static} {Code} {Analysis} for {Automated} {Code} {Quality} {Improvements}	2025	Ambiguo sin abstract
miyaji_empowering_2025	Empowering {Business} {Decisions} and {Knowledge} {Management} {Through} {Advanced} {RAG}-{Driven} {QA} {Systems}	2025	Ambiguo sin abstract
joseph_retrieval-augmented_2025	Retrieval-{Augmented} {LLMs} for {Culturally} {Sensitive} {Learning} {Content} in {Refugee} {Education}	2025	Ambiguo sin abstract
tashkovska_memoire_2025	Memoire: {Harnessing} {Generative} {AI} to {Bridge} the {Metacognitive} {Gap} in {Reflective} {Writing}	2025	Ambiguo sin abstract
fink_referral_2025	From {Referral} to {Reporting}: {The} {Potential} of {Large} {Language} {Models} in the {Radiological} {Workflow}; {Von} der {Indikationsstellung} bis zur {Befundung}: {Potential} von {Large} {Language} {Models} im radiologischen {Workflow}	2025	Ambiguo sin abstract
tel_rag_2025	{RAG} with {Knowledge} {Structures}	2025	Ambiguo sin abstract
wilkerson_case_2025	Case {Hallucinations} and {Steps} {Toward} {Repair}	2025	Ambiguo sin abstract
shen_large_2025	Large {Language} {Model}-{Driven} {Knowledge} {Discovery} for {Designing} {Advanced} {Micro}/{Nano} {Electrocatalyst} {Materials}	2025	Ambiguo sin abstract
karpe_infonest_2025	{InfoNest}: {Privacy} {Optimized} {Information} {Retrieval} {Generation} {System} {Using} {LLMs}	2025	Ambiguo sin abstract
tel_utilizing_2025	Utilizing the {Structure} of {Process} {Models} for {Guided} {Generation} of {Explanatory} {Texts}	2025	Ambiguo sin abstract
wojtasik_citeverifier_2025	{CiteVerifier}: {How} {Good} {Are} {Citation} {Verifiers} and {How} to {Use} {Them}?	2025	Ambiguo sin abstract
yang_multi-agent_2025	A {Multi}-{Agent} and {GraphRAG}-{Based} {Framework} for {Operation} and {Management} {Decision}-{Making} in {Hydraulic} {Projects}	2025	Ambiguo sin abstract
chen_exploring_2025	Exploring the {Role} of {Knowledge} {Graph}-{Based} {RAG} in {Japanese} {Medical} {Question} {Answering} with {Small}-{Scale} {LLMs}	2025	Ambiguo sin abstract
noauthor_international_2025	International {Conference} on {Data} {Science}, {Computation}, and {Security}, {IDSCS} 2024	2025	Ambiguo sin abstract
ming_faitheval_2025	{FAITHEVAL}: {CAN} {YOUR} {LANGUAGE} {MODEL} {STAY} {FAITHFUL} {TO} {CONTEXT}, {EVEN} {IF} “{THE} {MOON} {IS} {MADE} {OF} {MARSHMALLOWS}”	2025	Ambiguo sin abstract
li_benchmarking_2025	{BENCHMARKING} {MULTIMODAL} {RETRIEVAL} {AUGMENTED} {GENERATION} {WITH} {DYNAMIC} {VQA} {DATASET} {AND} {SELF}-{ADAPTIVE} {PLANNING} {AGENT}	2025	Ambiguo sin abstract
li_simple_2025	{SIMPLE} {IS} {EFFECTIVE}: {THE} {ROLES} {OF} {GRAPHS} {AND} {LARGE} {LANGUAGE} {MODELS} {IN} {KNOWLEDGE}-{GRAPH}-{BASED} {RETRIEVAL}-{AUGMENTED} {GENERATION}	2025	Ambiguo sin abstract
sun_redeep_2025	{REDEEP}: {DETECTING} {HALLUCINATION} {IN} {RETRIEVAL}-{AUGMENTED} {GENERATION} {VIA} {MECHANISTIC} {INTERPRETABILITY}	2025	Ambiguo sin abstract
leemann_auto-gda_2025	{AUTO}-{GDA}: {AUTOMATIC} {DOMAIN} {ADAPTATION} {FOR} {GROUNDING} {VERIFICATION} {IN} {RETRIEVAL}-{AUGMENTED} {GENERATION}	2025	Ambiguo sin abstract
chen_attention_2025	{ATTENTION} {IN} {LARGE} {LANGUAGE} {MODELS} {YIELDS} {EFFICIENT} {ZERO}-{SHOT} {RE}-{RANKERS}	2025	Ambiguo sin abstract
huang_trust_2025	{TO} {TRUST} {OR} {NOT} {TO} {TRUST}? {ENHANCING} {LARGE} {LANGUAGE} {MODELS}' {SITUATED} {FAITHFULNESS} {TO} {EXTERNAL} {CONTEXTS}	2025	Ambiguo sin abstract
jiang_reasoning-enhanced_2025	{REASONING}-{ENHANCED} {HEALTHCARE} {PREDICTIONS} {WITH} {KNOWLEDGE} {GRAPH} {COMMUNITY} {RETRIEVAL}	2025	Ambiguo sin abstract
seabra_enhancing_2025	Enhancing {Explainability} in {AI}-{Powered} {Data} {Retrieval} {Systems}	2025	Ambiguo sin abstract
joren_sufficient_2025	{SUFFICIENT} {CONTEXT}: {A} {NEW} {LENS} {ON} {RETRIEVAL} {AUGMENTED} {GENERATION} {SYSTEMS}	2025	Ambiguo sin abstract
li_rag-ddr_2025	{RAG}-{DDR}: {OPTIMIZING} {RETRIEVAL}-{AUGMENTED} {GENERATION} {USING} {DIFFERENTIABLE} {DATA} {REWARDS}	2025	Ambiguo sin abstract
liang_research_2025	Research on {Large} {Model}-{Based} {Information} {Processing} {Technology} and {Its} {Application} in {Local} {Life} in {Macau}	2025	Ambiguo sin abstract
joy_ai-powered_2025	{AI}-{Powered} {Technologies}: {Specification} {Review} and {Cost} {Analysis} of {Transportation} {Construction} {Projects}	2025	Ambiguo sin abstract
jing_when_2025	When {Large} {Language} {Models} {Meet} {Vector} {Databases}: {A} {Survey}	2025	Ambiguo sin abstract
noauthor_icocseti_2025	{ICoCSETI} 2025 - {International} {Conference} on {Computer} {Sciences}, {Engineering}, and {Technology} {Innovation}, {Proceeding}	2025	Ambiguo sin abstract
sahitaj_towards_2025	Towards {Automated} {Fact}-{Checking} of {Real}-{World} {Claims}: {Exploring} {Task} {Formulation} and {Assessment} with {LLMs}	2025	Ambiguo sin abstract
de_paoli_generative_2025	Generative {AI} {Meets} {Genomics}: {VarChat}, a {RAG}-{Based} {Approach} for {Literature}-{Driven} {Variant} {Summarization}	2025	Ambiguo sin abstract
park_system_2025	A {System} {Design} and {Development} of {Big} {Data} {Assistant} for {Generative} {AI}-{Driven} {Customer} {Segmentation} and {Real}-{Time} {Target} {Marketing}	2025	Ambiguo sin abstract
noauthor_workshop_2025-1	Workshop on {Advanced} {Data}-{Driven} {Techniques} for {Urban} {Resilience}, {ADUR} 2025, {Workshop} of {Foundational} {AI} for {Pervasive} {Computing}, {FairPC} 2025, {Workshop} on {Graph} {Learning} with {Foundation} {Models}, {GLFM} 2025, {Workshop} on {Pattern} {Mining} and {Machine} {Learning} for {Bioinformatics}, {PM4B} 2025, {Workshop} on {Research} and {Applications} of {Foundation} {Models} for {Data} {Mining} and {Affective} {Computing}, {RAFDA} 2025, held in conjunction with the 29th {Pacific}-{Asia} {Conference} on {Knowledge} {Discovery} and {Data} {Mining}, {PAKDD} 2025	2025	Ambiguo sin abstract
yang_towards_2025	Towards {Retrieval}-{Augmented} {Large} {Language} {Model}-{Based} {Conversational} {Recommender} {System}	2025	Ambiguo sin abstract
hodges_using_2025	Using {AI} to {Improve} {Diagnosis} and {Treatment} of {Rare} {Diseases}: {A} {Chat} {Agent} for {Equitable} and {Accessible} {Healthcare}	2025	Ambiguo sin abstract
nemeth_exploring_2025	Exploring the use of retrieval-augmented generation models in higher education: {A} pilot study on artificial intelligence-based tutoring	2025	Ambiguo sin abstract
zhu_hybrid_2025	Hybrid {Feature} {Fusion} for {Enhancing} {Medical} {Document} {Embedding}	2025	Ambiguo sin abstract
noauthor_proceedings_2025-2	Proceedings - 2025 {IEEE}/{ACM} 4th {International} {Conference} on {AI} {Engineering} - {Software} {Engineering} for {AI}, {CAIN} 2025	2025	Ambiguo sin abstract
chis_graphxx_2025	{GRAPHxx}: {DSML} engineering for knowledge graph building and streamlining with {GraphRAG}	2025	Ambiguo sin abstract
wulf_impact_2025	The {Impact} of {Large} {Language} {Models} on {Task} {Automation} in {Manufacturing} {Services}	2025	Ambiguo sin abstract
he_external_2025	External {Retrievals} or {Internal} {Priors}? {From} {RAG} to {Epitome}-{Augmented} {Generation} by {Fuzzy} {Selection}	2025	Ambiguo sin abstract
firsanova_aggile_2025	{AGGILE}: {Automated} {Graph} {Generation} for {Inference} and {Language} {Exploration}	2025	Ambiguo sin abstract
tseng_designing_2025	Designing an {AI} {Chatbot} for {Team}-{Based} {Diabetes} {Care}: {An} {Iterative} {Human}-in-the-{Loop} {Approach}	2025	Ambiguo sin abstract
zhang_knowledge-enhanced_2025	A {Knowledge}-{Enhanced} {Platform} ({MetaSepsisKnowHub}) for {Retrieval} {Augmented} {Generation}–{Based} {Sepsis} {Heterogeneity} and {Personalized} {Management}: {Development} {Study}	2025	Ambiguo sin abstract
li_enhancing_2025	Enhancing {Pulmonary} {Disease} {Prediction} {Using} {Large} {Language} {Models} {With} {Feature} {Summarization} and {Hybrid} {Retrieval}-{Augmented} {Generation}: {Multicenter} {Methodological} {Study} {Based} on {Radiology} {Report}	2025	Ambiguo sin abstract
ilagan_virtual_2025	A {Virtual} {Support} {Agent} for {University} {Students} {Powered} by a {Large} {Language} {Model}: {Conversational} {User} {Experience} {Design} {Considerations}	2025	Ambiguo sin abstract
lotfi_rethinking_2025	Rethinking {Strategic} {Mechanism} {Design} {In} {The} {Age} {Of} {Large} {Language} {Models}: {New} {Directions} {For} {Communication} {Systems}	2025	Ambiguo sin abstract
ye_intelligent_2025	Intelligent {Tutoring} {Agent} with {Retrieval}-{Augmented} {Generation}: {A} {Case} {Study} of {Quality} {Management} {System} {Course}	2025	Ambiguo sin abstract
zhang_cmedragbot_2025	{CMedRAGBot}: {A} {Chinese} {Medical} {Chatbot} {Based} on {Graph} {RAG} and {Large} {Language} {Models}	2025	Ambiguo sin abstract
chen_predicting_2025	Predicting 30-{Day} {Postoperative} {Mortality} and {American} {Society} of {Anesthesiologists} {Physical} {Status} {Using} {Retrieval}-{Augmented} {Large} {Language} {Models}: {Development} and {Validation} {Study}	2025	Ambiguo sin abstract
hwang_efficient_2025	Efficient {Information} {Search} {Techniques} for {Similar} {Documents} in {AI} {Chatbots}	2025	Ambiguo sin abstract
sirisha_analytical_2025	An {Analytical} {Review} of {Large} {Language} {Models} {Leveraging} {KDGI} {Fine}-{Tuning}, {Quantum} {Embedding}’s, and {Multimodal} {Architectures}	2025	Ambiguo sin abstract
alam_towards_2025	Towards {Interpretable} {Radiology} {Report} {Generation} via {Concept} {Bottlenecks} {Using} a {Multi}-agentic {RAG}	2025	Ambiguo sin abstract
wang_nas-based_2025	A {NAS}-{Based} {Risk} {Prediction} {Model} and {Interpretable} {System} for {Amyloidosis}	2025	Ambiguo sin abstract
varma_data_2025	From {Data} to {Decisions}: {Enterprise}-{Level} {Domain}-{Specific} {Graph} {Retrieval}-{Augmented} {Generation} {Systems} for {Advanced} {Question} {Answering}	2025	Ambiguo sin abstract
ateia_bioragent_2025	{BioRAGent}: {A} {Retrieval}-{Augmented} {Generation} {System} for {Showcasing} {Generative} {Query} {Expansion} and {Domain}-{Specific} {Search} for {Scientific} {Q}\&{A}	2025	Ambiguo sin abstract
bao_mindwell_2025	{MindWell}: {A} {Conversational} {Agent} for {Professional} {Depression} {Screening} on {Social} {Media}	2025	Ambiguo sin abstract
abras_can_2025	Can {Generative} {AI} {Mitigate} {Strategic} {Decision}-{Making} {Complexity}? {An} {Empirical} {Exploration} of {RAG}-{Augmented} {Decision}-{Support} {Systems}	2025	Ambiguo sin abstract
al-machot_building_2025	Building {Trustworthy} {AI}: {Transparent} {AI} {Systems} via {Language} {Models}, {Ontologies}, and {Logical} {Reasoning} ({TranspNet})	2025	Ambiguo sin abstract
elyas_tailoring_2025	Tailoring {Large} {Language} {Models} for {Drilling} {Applications}: {A} {Comparative} {Study} of {Retrieval}-{Augmented} {Generation} and {Fine}-{Tuning}	2025	Ambiguo sin abstract
tan_llama-utp_2025	{LLaMA}-{UTP}: {Knowledge}-{Guided} {Expert} {Mixture} for {Analyzing} {Uncertain} {Tax} {Positions}	2025	Ambiguo sin abstract
arnold_pilot_2025	A {Pilot} {Study}: {Naive} smart interfaces can cause accidents	2025	Ambiguo sin abstract
rai_echo_2025	Echo {Chamber}: {Uncovering} the {Public} {Views} on {Ultrasounds} via {Advanced} {Social} {Media} {Listening}	2025	Ambiguo sin abstract
hang_trumorgpt_2025	{TrumorGPT}: {Graph}-{Based} {Retrieval}-{Augmented} {Large} {Language} {Model} for {Fact}-{Checking}	2025	Ambiguo sin abstract
kelly_effectiveness_2025	The {Effectiveness} of a {Custom} {AI} {Chatbot} for {Type} 2 {Diabetes} {Mellitus} {Health} {Literacy}: {Development} and {Evaluation} {Study}	2025	Ambiguo sin abstract
li_use_2025	Use of {Retrieval}-{Augmented} {Large} {Language} {Model} for {COVID}-19 {Fact}-{Checking}: {Development} and {Usability} {Study}	2025	Ambiguo sin abstract
pampel_regaining_2025	Regaining {Control}: {Enabling} {Educators} to {Build} {Specialized} {AI} {Chat} {Bots} with {Retrieval} {Augmented} {Generation}	2025	Ambiguo sin abstract
emonet_llm-based_2025	{LLM}-based {SPARQL} {Query} {Generation} from {Natural} {Language} over {Federated} {Knowledge} {Graphs}	2025	Ambiguo sin abstract
sarmiento_investigating_2025	Investigating {Flavors} of {RAG} for {Applications} in {College} {Chatbots}	2025	Ambiguo sin abstract
kaczmarek_optimizing_2025	Optimizing {Retrieval}-{Augmented} {Generation} of {Medical} {Content} for {Spaced} {Repetition} {Learning}	2025	Ambiguo sin abstract
hoffmann_text_2025	From {Text} to {Text} {Game}: {A} {Novel} {RAG} {Approach} to {Gamifying} {Anthropological} {Literature} and {Build} {Thick} {Games}	2025	Ambiguo sin abstract
clay_information_2025	Information for {Conversation} {Generation}: {Proposals} {Utilising} {Knowledge} {Graphs}	2025	Ambiguo sin abstract
berry_utilizing_2025	Utilizing large language models for gastroenterology research: a conceptual framework	2025	Ambiguo sin abstract
benavent_raging_2025	{RAGing} ahead in rheumatology: new language model architectures to tame artificial intelligence	2025	Ambiguo sin abstract
noauthor_8th_2025	8th {International} {Workshop} on {Chatbots} and {Human}-{Centered} {AI}, {CONVERSATIONS} 2024	2025	Ambiguo sin abstract
temsah_authors_2025	Authors’ {Reply}: {Citation} {Accuracy} {Challenges} {Posed} by {Large} {Language} {Models}	2025	Ambiguo sin abstract
akilesh_multi-agent_2025	Multi-{Agent} hierarchical workflow for autonomous code generation with {Large} {Language} {Models}	2025	Ambiguo sin abstract
bhiwgade_integrating_2025-1	Integrating {Open}-{Source} {LLMs} with {Retrieval}-{Augmented} {Generation} for {Obstetrics} and {Gynecology} {Domain}	2025	Ambiguo sin abstract
zheng_knowledge-based_2025	Knowledge-{Based} {Question} {Answering} {System} for {Hydraulic} {Hoist} {Using} {Large} {Language} {Models}	2025	Ambiguo sin abstract
khan_rfsensinggpt_2025	{RFSensingGPT}: {A} {Multi}-{Modal} {RAG}-{Enhanced} {Framework} for {Integrated} {Sensing} and {Communications} {Intelligence} in {6G} {Networks}	2025	Ambiguo sin abstract
yu_ba-gpt_2025	{BA}-{GPT}: {Battlefield} {Awareness} {Interactive} {Q}\&{A} {System} {Based} on {RAG}	2025	Ambiguo sin abstract
orlowski_towards_2025	Towards {Personal} {Assistants} for {Energy} {Processes} {Based} on {Locally} {Deployed} {LLMs}	2025	Ambiguo sin abstract
guttikonda_explainable_2025	Explainable {AI}: {A} {Retrieval}-{Augmented} {Generation} {Based} {Framework} for {Model} {Interpretability}	2025	Ambiguo sin abstract
santos_using_2025	Using {LLMs} to bridge the gap between consumers and {Blockchain} on a {Agro}-food traceability platform: {An} architectural proposal	2025	Ambiguo sin abstract
noauthor_11th_2025	11th {International} {Conference} on {Information} {Systems} {Security} and {Privacy}, {ICISSP} 2025	2025	Ambiguo sin abstract
awadid_ritsa_2025	{RITSA}: {Toward} a {Retrieval}-{Augmented} {Generation} {System} for {Intelligent} {Transportation} {Systems} {Architecture}	2025	Ambiguo sin abstract
reza_crix_2025	{CriX}: {Intersection} of {Crime}, {Demographics} and {Explainable} {AI}	2025	Ambiguo sin abstract
lorusso_gollum_2025	{GOLLUM}: {Guiding} {cOnfiguration} of {firewaLL} {Through} {aUgmented} {Large} {Language} {Models}	2025	Ambiguo sin abstract
maruyama_retrieval-augmented_2025	Retrieval-augmented generation enhances large language model performance on the {Japanese} orthopedic board examination	2025	Ambiguo sin abstract
barghi_qrag_2025	{QRAG}: {Using} {Learnable} {Graph} {Queries} for {Retrieval} {Augmented} {Generation}	2025	Ambiguo sin abstract
ecker_trust-informed_2025	Trust-{Informed} {Large} {Language} {Models} via {Word} {Embedding}-{Knowledge} {Graph} {Alignment}	2025	Ambiguo sin abstract
hou_improving_2025	Improving {Dietary} {Supplement} {Information} {Retrieval}: {Development} of a {Retrieval}-{Augmented} {Generation} {System} {With} {Large} {Language} {Models}	2025	Ambiguo sin abstract
bassiouny_uji-butler_2025	{UJI}-{Butler}: {A} {Symbolic}/{Non}-symbolic {Robotic} {System} that {Learns} {Through} {Multi}-modal {Interaction}	2025	Ambiguo sin abstract
malandri_re-fin_2025	{RE}-{FIN}: {Retrieval}-based {Enrichment} for {Financial} data	2025	Ambiguo sin abstract
zhou_ihillm-rag_2025	{IHILLM}-{RAG}: {A} safe and private medical large language model based on intelligent hardware interaction and retrieval-augmented generation({RAG})	2025	Ambiguo sin abstract
chen_seeing_2025	Seeing {Beyond}: {Enhancing} {Visual} {Question} {Answering} with {Multi}-{Modal} {Retrieval}	2025	Ambiguo sin abstract
lu_decoding_2025	Decoding urban policies: {NLP}-driven concise explanations	2025	Ambiguo sin abstract
kliestik_enterprise_2024	Enterprise generative artificial intelligence technologies, internet of things and blockchain-based fintech management, and digital twin industrial metaverse in the cognitive algorithmic economy	2024	Ambiguo sin abstract
lee_poster_2024	Poster {Abstract}: {An} {LLM}-driven {Framework} for {Dynamic} {Infrastructure} as {Code} {Generation}	2024	Ambiguo sin abstract
vassos_now_2024	Now {I} know! {Empowering} {Voters} with {RAG}-enabled {LLMs} to {Eliminate} {Political} {Uncertainty}	2024	Ambiguo sin abstract
noauthor_sigir-ap_2024	{SIGIR}-{AP} 2024 - {Proceedings} of the 2024 {Annual} {International} {ACM} {SIGIR} {Conference} on {Research} and {Development} in {Information} {Retrieval} in the {Asia} {Pacific} {Region}	2024	Ambiguo sin abstract
malaborbor_enhancing_2024	Enhancing {Data} {Privacy} {Literacy} through {Conversational} {AI}: {A} {QandA}-{Based} {Approach} to {Educating} {Users} on the {Provisions} of the {Data} {Privacy} {Act} of 2012	2024	Ambiguo sin abstract
zhao_embodied_2024	Embodied {AI}-{Guided} {Interactive} {Digital} {Teachers} for {Education}	2024	Ambiguo sin abstract
rajeshkumar_dermai_2024	{DermAI}: {An} {Innovative} {AI}-{Driven} {Chatbot} for {Enhanced} {Dermatological} {Diagnosis} and {Patient} {Interaction}	2024	Ambiguo sin abstract
lee_enhancing_2024	Enhancing {Large} {Language} {Model} {Reliability}: {Minimizing} {Hallucinations} with {Dual} {Retrieval}-{Augmented} {Generation} {Based} on the {Latest} {Diabetes} {Guidelines}	2024	Ambiguo sin abstract
zhang_generative_2024	Generative {AI} in {Medicine} and {Healthcare}: {Moving} {Beyond} the ‘{Peak} of {Inflated} {Expectations}’	2024	Ambiguo sin abstract
earley_powerful_2024	Powerful tools for personalisation: {Using} large language model-based agents, knowledge graphs and customer signals to connect with users	2024	Ambiguo sin abstract
chen_enhanced_2024	An {Enhanced} {Retrieval} {Scheme} for a {Large} {Language} {Model} with a {Joint} {Strategy} of {Probabilistic} {Relevance} and {Semantic} {Association} in the {Vertical} {Domain}	2024	Ambiguo sin abstract
yao_adaptive_2024	Adaptive {Control} of {Retrieval}-{Augmented} {Generation} for {Large} {Language} {Models} {Through} {Reflective} {Tags}	2024	Ambiguo sin abstract
paneru_leveraging_2024	Leveraging {AI} in ayurvedic agriculture: {A} {RAG} chatbot for comprehensive medicinal plant insights using hybrid deep learning approaches	2024	Ambiguo sin abstract
toro_dynamic_2024	Dynamic {Retrieval} {Augmented} {Generation} of {Ontologies} using {Artificial} {Intelligence} ({DRAGON}-{AI})	2024	Ambiguo sin abstract
gue_evaluating_2024	Evaluating the {OpenAI}’s {GPT}-3.5 {Turbo}’s performance in extracting information from scientific articles on diabetic retinopathy	2024	Ambiguo sin abstract
kresevic_optimization_2024	Optimization of hepatological clinical guidelines interpretation by large language models: a retrieval augmented generation-based framework	2024	Ambiguo sin abstract
soh_data_2024	Data science solutions on azure: {The} rise of generative {AI} and applied {AI}	2024	Ambiguo sin abstract
cho_fishnet_2024	{FISHNET}: {Financial} {Intelligence} from {Sub}-querying, {Harmonizing}, {Neural}-{Conditioning}, {Expert} {Swarms}, and {Task} {Planning}	2024	Ambiguo sin abstract
li_leveraging_2024	Leveraging {Prompt} {Tuning}-{Based} {Cognitive} {Attention} to {Enhance} {Logical} {Inference} in {Large} {Language} {Models}	2024	Ambiguo sin abstract
moric_integrating_2024	Integrating a {Virtual} {Assistant} by {Using} the {RAG} {Method} and {VERTEX} {AI} {Framework} at {Algebra} {University}	2024	Ambiguo sin abstract
song_travelrag_2024	{TravelRAG}: {A} {Tourist} {Attraction} {Retrieval} {Framework} {Based} on {Multi}-{Layer} {Knowledge} {Graph}	2024	Ambiguo sin abstract
ge_development_2024	Development of a liver disease-specific large language model chat interface using retrieval-augmented generation	2024	Ambiguo sin abstract
xu_p-rag_2024	P-{RAG}: {Progressive} {Retrieval} {Augmented} {Generation} for {Planning} on {Embodied} {Everyday} {Task}	2024	Ambiguo sin abstract
wang_topology-aware_2024	Topology-aware {Retrieval} {Augmentation} for {Text} {Generation}	2024	Ambiguo sin abstract
shi_retrieval-enhanced_2024	Retrieval-enhanced {Knowledge} {Editing} in {Language} {Models} for {Multi}-{Hop} {Question} {Answering}	2024	Ambiguo sin abstract
le_anspre_2024	{ANSPRE}: {Improving} {Question}-{Answering} in {Large} {Language} {Models} with {Answer}-{Prefix} {Generation}	2024	Ambiguo sin abstract
chen_ontology_2024	Ontology {Text} {Alignment}: {Aligning} {Textual} {Content} to {Terminological} {Axioms}	2024	Ambiguo sin abstract
wei_garag_2024	{GARAG}: {A} {General} adaptive question-answering system based on {RAG}	2024	Ambiguo sin abstract
lammert_expert-guided_2024	Expert-{Guided} {Large} {Language} {Models} for {Clinical} {Decision} {Support} in {Precision} {Oncology}	2024	Ambiguo sin abstract
iaroshev_evaluating_2024	Evaluating {Retrieval}-{Augmented} {Generation} {Models} for {Financial} {Report} {Question} and {Answering}	2024	Ambiguo sin abstract
han_automating_2024	Automating {Systematic} {Literature} {Reviews} with {Retrieval}-{Augmented} {Generation}: {A} {Comprehensive} {Overview}	2024	Ambiguo sin abstract
wysocka_large_2024	Large {Language} {Models}, scientific knowledge and factuality: {A} framework to streamline human expert evaluation	2024	Ambiguo sin abstract
arun_chatgpt_2024	{ChatGPT} versus a customized {AI} chatbot ({Anatbuddy}) for anatomy education: {A} comparative pilot study	2024	Ambiguo sin abstract
guo_knowledgenavigator_2024	{KnowledgeNavigator}: leveraging large language models for enhanced reasoning over knowledge graph	2024	Ambiguo sin abstract
ascorbe_automatic_2024	Automatic and {Manual} {Evaluation} of a {Spanish} {Suicide} {Information} {Chatbot}; {Evaluación} automática y manual de un chatbot para proporcionar información sobre suicidio en castellano	2024	Ambiguo sin abstract
soman_biomedical_2024	Biomedical knowledge graph-optimized prompt generation for large language models	2024	Ambiguo sin abstract
mansurova_qa-rag_2024	{QA}-{RAG}: {Exploring} {LLM} {Reliance} on {External} {Knowledge}	2024	Ambiguo sin abstract
byun_design_2024	Design and {Implementation} of an {Interactive} {Question}-{Answering} {System} with {Retrieval}-{Augmented} {Generation} for {Personalized} {Databases}	2024	Ambiguo sin abstract
alonso_medexpqa_2024	{MedExpQA}: {Multilingual} benchmarking of {Large} {Language} {Models} for {Medical} {Question} {Answering}	2024	Ambiguo sin abstract
li_refai_2024	{RefAI}: a {GPT}-powered retrieval-augmented generative tool for biomedical literature recommendation and summarization	2024	Ambiguo sin abstract
giuffre_optimizing_2024	Optimizing large language models in digestive disease: strategies and challenges to improve clinical outcomes	2024	Ambiguo sin abstract
alkhalaf_applying_2024	Applying generative {AI} with retrieval augmented generation to summarize and extract key clinical information from electronic health records	2024	Ambiguo sin abstract
wang_mememo_2024	{MeMemo}: {On}-device {Retrieval} {Augmentation} for {Private} and {Personalized} {Text} {Generation}	2024	Ambiguo sin abstract
li_corpuslm_2024	{CorpusLM}: {Towards} a {Unified} {Language} {Model} on {Corpus} for {Knowledge}-{Intensive} {Tasks}	2024	Ambiguo sin abstract
zhang_are_2024	Are {Large} {Language} {Models} {Good} at {Utility} {Judgments}?	2024	Ambiguo sin abstract
church_emerging_2024	Emerging trends: {A} gentle introduction to {RAG}	2024	Ambiguo sin abstract
jearanaitanakij_thai_2024	Thai {Question}-{Answering} {System} {Using} {Similarity} {Search} and {LLM}	2024	Ambiguo sin abstract
alghamdi_towards_2024	Towards {Reliable} {Healthcare} {LLM} {Agents}: {A} {Case} {Study} for {Pilgrims} during {Hajj}	2024	Ambiguo sin abstract
suresh_towards_2024	Towards a {RAG}-based summarization for the {Electron} {Ion} {Collider}	2024	Ambiguo sin abstract
matsumoto_kragen_2024	{KRAGEN}: a knowledge graph-enhanced {RAG} framework for biomedical problem solving using large language models	2024	Ambiguo sin abstract
murugan_empowering_2024	Empowering personalized pharmacogenomics with generative {AI} solutions	2024	Ambiguo sin abstract
dernbach_glam_2024	{GLaM}: {Fine}-{Tuning} {Large} {Language} {Models} for {Domain} {Knowledge} {Graph} {Alignment} via {Neighborhood} {Partitioning} and {Generative} {Subgraph} {Encoding}	2024	Ambiguo sin abstract
toukmaji_retrieval-augmented_2024	Retrieval-{Augmented} {Generation} and {LLM} {Agents} for {Biomimicry} {Design} {Solutions}	2024	Ambiguo sin abstract
venkatakrishnan_semantic_2024	Semantic interlinking of {Immigration} {Data} using {LLMs} for {Knowledge} {Graph} {Construction}	2024	Ambiguo sin abstract
xu_search---chain_2024	Search-in-the-{Chain}: {Interactively} {Enhancing} {Large} {Language} {Models} with {Search} for {Knowledge}-intensive {Tasks}	2024	Ambiguo sin abstract
leekha_war_2024	War of {Words}: {Harnessing} the {Potential} of {Large} {Language} {Models} and {Retrieval} {Augmented} {Generation} to {Classify}, {Counter} and {Diffuse} {Hate} {Speech}	2024	Ambiguo sin abstract
sharma_reliable_2024	A reliable knowledge processing framework for combustion science using foundation models	2024	Ambiguo sin abstract
chen_benchmarking_2024	Benchmarking {Large} {Language} {Models} in {Retrieval}-{Augmented} {Generation}	2024	Ambiguo sin abstract
odede_jaybot_2024	{JayBot} - {Aiding} {University} {Students} and {Admission} with an {LLM}-based {Chatbot}	2024	Ambiguo sin abstract
volker_chat_2024	From {Chat} to {Publication} {Management}: {Organizing} your related work using {BibSonomy} \& {LLMs}	2024	Ambiguo sin abstract
seas_commentary_2024	Commentary on “{Use} of {ChatGPT} for {Determining} {Clinical} and {Surgical} {Treatment} of {Lumbar} {Disc} {Herniation} {With} {Radiculopathy}: {A} {North} {American} {Spine} {Society} {Guideline} {Comparison}”	2024	Ambiguo sin abstract
miao_integrating_2024	Integrating {Retrieval}-{Augmented} {Generation} with {Large} {Language} {Models} in {Nephrology}: {Advancing} {Practical} {Applications}	2024	Ambiguo sin abstract
putri_simplification_2024	Simplification of {Embedding} {Process} in {Retrieval} {Augmented} {Generation} for {Optimizing} {Question} {Answering} {Chatbot} {Model}	2024	Ambiguo sin abstract
zemicheal_llm_2024	{LLM} agents for vulnerability identification and verification of {CVEs}	2024	Ambiguo sin abstract
taormina_interpretable_2024	Interpretable {Sewer} {Defect} {Detection} with {Large} {Multimodal} {Models} †	2024	Ambiguo sin abstract
jiang_medirag_2024	{MediRAG}: {Secure} {Question} {Answering} for {Healthcare} {Data}	2024	Ambiguo sin abstract
zhu_atm_2024	{ATM}: {Adversarial} {Tuning} {Multi}-agent {System} {Makes} a {Robust} {Retrieval}-{Augmented} {GENERATOR}	2024	Ambiguo sin abstract
qi_model_2024	Model {Internals}-based {Answer} {Attribution} for {Trustworthy} {Retrieval}-{Augmented} {Generation}	2024	Ambiguo sin abstract
jin_dvd_2024	{DVD}: {Dynamic} {Contrastive} {Decoding} for {Knowledge} {Amplification} in {Multi}-{Document} {Question} {Answering}	2024	Ambiguo sin abstract
buchmann_attribute_2024	Attribute or {Abstain}: {Large} {Language} {Models} as {Long} {Document} {Assistants}	2024	Ambiguo sin abstract
chen_controlling_2024	Controlling {Risk} of {Retrieval}-augmented {Generation}: {A} {Counterfactual} {Prompting} {Framework}	2024	Ambiguo sin abstract
cao_tonggu_2024	{TongGu}: {Mastering} {Classical} {Chinese} {Understanding} with {Knowledge}-{Grounded} {Large} {Language} {Models}	2024	Ambiguo sin abstract
thakur_knowing_2024	“{Knowing} {When} {You} {Don}'t {Know}”: {A} {Multilingual} {Relevance} {Assessment} {Dataset} for {Robust} {Retrieval}-{Augmented} {Generation}	2024	Ambiguo sin abstract
yao_readme_2024	{README}: {Bridging} {Medical} {Jargon} and {Lay} {Understanding} for {Patient} {Education} through {Data}-{Centric} {NLP}	2024	Ambiguo sin abstract
li_refiner_2024	Refiner: {Restructure} {Retrieval} {Content} {Efficiently} to {Advance} {Question}-{Answering} {Capabilities}	2024	Ambiguo sin abstract
xu_chat_2024	A {Chat} {Bot} for {Enrollment} of {Xi} 'an {Jiaotong}-{Liverpool} {University} {Based} on {RAG}	2024	Ambiguo sin abstract
noauthor_proceedings_2024	Proceedings of {ALTRUIST} {Workshop} on {SociAL} {RoboTs} for {PeRsonalized}, {ContinUous} and {AdaptIve} {ASsisTance}, {BAILAR} {Workshop} on {Behavior} {Adaptation} and {Learning} for {Assistive} {Robotics}, {SCRITA} {Workshop} on {Trust}, {Acceptance} and {Social} {Cues} in {Human}-{Robot} {Interaction}, and {WARN} {Workshop} on {Weighing} the {Benefits} of {Autonomous} {Robot} {PersoNalisation}, {ALTRUIST}-{BAILAR}-{SCRITA}-{WARN} 2024 - co-located with {Ro}-{MAN} 2024	2024	Ambiguo sin abstract
redelaar_attributed_2024	Attributed {Question} {Answering} for {Preconditions} in the {Dutch} {Law}	2024	Ambiguo sin abstract
beauchemin_quebec_2024	Quebec {Automobile} {Insurance} {Question}-{AnsweringWith} {Retrieval}-{Augmented} {Generation}	2024	Ambiguo sin abstract
anaguchi_reasoning_2024	Reasoning and {Justification} {System} for {Domestic} {Hazardous} {Behaviors} {Based} on {Knowledge} {Graph} of {Daily} {Activities} and {Retrieval}-{Augmented} {Generation}	2024	Ambiguo sin abstract
li_bordirlines_2024	{BORDIRLINES}: {A} {Dataset} for {Evaluating} {Cross}-lingual {Retrieval}-{Augmented} {Generation}	2024	Ambiguo sin abstract
noauthor_emnlp_2024	{EMNLP} 2024 - 2024 {Conference} on {Empirical} {Methods} in {Natural} {Language} {Processing}, {Proceedings} of the {Industry} {Track}	2024	Ambiguo sin abstract
sankararaman_provenance_2024	Provenance: {A} {Light}-weight {Fact}-checker for {Retrieval} {Augmented} {LLM} {Generation} {Output}	2024	Ambiguo sin abstract
penzkofer_evaluating_2024	Evaluating and {Fine}-{Tuning} {Retrieval}-{Augmented} {Language} {Models} to {Generate} {Text} {With} {Accurate} {Citations}	2024	Ambiguo sin abstract
zimmerman_two-tiered_2024	Two-tiered {Encoder}-based {Hallucination} {Detection} for {Retrieval}-{Augmented} {Generation} in the {Wild}	2024	Ambiguo sin abstract
kalra_hypa-rag_2024	{HyPA}-{RAG}: {A} {Hybrid} {Parameter} {Adaptive} {Retrieval}-{Augmented} {Generation} {System} for {AI} {Legal} and {Policy} {Applications}	2024	Ambiguo sin abstract
zhang_raglab_2024	{RAGLAB}: {A} {Modular} and {Research}-{Oriented} {Unified} {Framework} for {Retrieval}-{Augmented} {Generation}	2024	Ambiguo sin abstract
bruzzone_generative_2024	Generative {AI} and {Retrieval}-{Augmented} {Generation} ({RAG}) in an {Agent}-{Based} {Simulation} {Framework} for {Urban} {Planning}	2024	Ambiguo sin abstract
noauthor_2024_2024	2024 {Design} and {Verification} {Conference} and {Exhibition} {Europe}, {DVCon} {Europe} 2024 - {Proceedings}	2024	Ambiguo sin abstract
chen_ipl_2024	{IPL}: {Leveraging} {Multimodal} {Large} {Language} {Models} for {Intelligent} {Product} {Listing}	2024	Ambiguo sin abstract
mandal_iitk_2024	{IITK} at {SemEval}-2024 {Task} 2: {Exploring} the {Capabilities} of {LLMs} for {Safe} {Biomedical} {Natural} {Language} {Inference} for {Clinical} {Trials}	2024	Ambiguo sin abstract
he_infrrdai_2024	Infrrd.ai at {SemEval}-2024 {Task} 7: {RAG}-based end-to-end training to generate headlines and numbers	2024	Ambiguo sin abstract
knollmeyer_benchmarking_2024	Benchmarking of {Retrieval} {Augmented} {Generation}: {A} {Comprehensive} {Systematic} {Literature} {Review} on {Evaluation} {Dimensions}, {Evaluation} {Metrics} and {Datasets}	2024	Ambiguo sin abstract
swapnil_automation_2024	From {Automation} to {Innovation}: {Harnessing} the {Synergy} of {Generative} {AI} and {Retrieval}-{Augmented} {Generation} for {Citizen}-centric {Governance}	2024	Ambiguo sin abstract
rai_generative_2024	Generative {AI} and {Large} {Language} {Model} {Assisted} {Causal} {Discovery} and {Inference} for {Driving} {Process} {Improvements}	2024	Ambiguo sin abstract
singh_application_2024	Application of {Generative} {AI} to {Derive} {Insight} from {Supply} {Chain} \& {Logistics} {Contracts}	2024	Ambiguo sin abstract
gummadi_enhancing_2024	Enhancing {Communication} and {Data} {Transmission} {Security} in {RAG} {Using} {Large} {Language} {Models}	2024	Ambiguo sin abstract
zhang_synthetic_2024	Synthetic {Knowledge} {Ingestion}: {Towards} {Knowledge} {Refinement} and {Injection} for {Enhancing} {Large} {Language} {Models}	2024	Ambiguo sin abstract
laban_summary_2024	Summary of a {Haystack}: {A} {Challenge} to {Long}-{Context} {LLMs} and {RAG} {Systems}	2024	Ambiguo sin abstract
badurowicz_feasibility_2024	{FEASIBILITY} {OF} {USING} {LOW}-{PARAMETER} {LOCAL} {LLMS} {IN} {ANSWERING} {QUESTIONS} {FROM} {ENTERPRISE} {KNOWLEDGE} {BASE}	2024	Ambiguo sin abstract
abdelaziem_innovative_2024	Innovative {Approach} of {Generative} {AI} for {Automating} {Technical} {Bid} {Evaluations} in {Oil} {Companies}	2024	Ambiguo sin abstract
he_retrieving_2024	Retrieving, {Rethinking} and {Revising}: {The} {Chain}-of-{Verification} {Can} {Improve} {Retrieval} {Augmented} {Generation}	2024	Ambiguo sin abstract
siragusa_unipa-gpt_2024	Unipa-{GPT}: a framework to assess open-source alternatives to {Chat}-{GPT} for {Italian} chat-bots	2024	Ambiguo sin abstract
su_parameter_2024	Parameter recommendation system enhanced by {RAG} based on process knowledge	2024	Ambiguo sin abstract
jauhiainen_evaluating_2024	Evaluating {Students}’ {Open}-ended {Written} {Responses} with {LLMs}: {Using} the {RAG} {Framework} for {GPT}-3.5, {GPT}-4, {Claude}-3, and {Mistral}-{Large}	2024	Ambiguo sin abstract
lu_triageagent_2024	{TRIAGEAGENT}: {Towards} {Better} {Multi}-{Agents} {Collaborations} for {Large} {Language} {Model}-{Based} {Clinical} {Triage}	2024	Ambiguo sin abstract
zhang_ask_2024	Ask {NAEP}: {A} {Generative} {AI} {Assistant} for {Querying} {Assessment} {Information}	2024	Ambiguo sin abstract
wang_searching_2024	Searching for {Best} {Practices} in {Retrieval}-{Augmented} {Generation}	2024	Ambiguo sin abstract
el_maazouzi_optimizing_2024	Optimizing {Recommendation} {Systems} in {E}-{Learning}: {Synergistic} {Integration} of {Lang} {Chain}, {GPT} {Models}, and {Retrieval} {Augmented} {Generation} ({RAG})	2024	Ambiguo sin abstract
noauthor_proceedings_2024-1	Proceedings - 2024 {International} {Conference} on {Assured} {Autonomy}, {ICAA} 2024	2024	Ambiguo sin abstract
ghali_enhancing_2024	Enhancing {Retrieval} {Processes} for {Language} {Generation} with {Augmented} {Queries} to {Provide} {Factual} {Information} on {Schizophrenia}	2024	Ambiguo sin abstract
conia_towards_2024	Towards {Cross}-{Cultural} {Machine} {Translation} with {Retrieval}-{Augmented} {Generation} from {Multilingual} {Knowledge} {Graphs}	2024	Ambiguo sin abstract
chen_eyegpt_2024	{EyeGPT} for {Patient} {Inquiries} and {Medical} {Education}: {Development} and {Validation} of an {Ophthalmology} {Large} {Language} {Model}	2024	Ambiguo sin abstract
isbarov_enhanced_2024	Enhanced document retrieval with topic embeddings	2024	Ambiguo sin abstract
armant_can_2024	Can {Knowledge} {Graphs} and {Retrieval}-{Augmented} {Generation} be combined to {Explain} {Query}/{Answer} {Relationships} {Truthfully}?	2024	Ambiguo sin abstract
ullrich_aic_2024	{AIC} {CTU} system at {AVeriTeC}: {Re}-framing automated fact-checking as a simple {RAG} task	2024	Ambiguo sin abstract
noauthor_mai-xai24_2024	{MAI}-{XAI24} 2024 - {Proceedings} of the 1st {Multimodal}, {Affective} and {Interactive} {eXplainable} {AI} {Workshop}, co-located with 27th {European} {Conference} on {Artificial} {Intelligence}, {ECAI} 2024	2024	Ambiguo sin abstract
gulden_leveraging_2024	Leveraging {Large} {Language} {Models} for {Comprehensive} {Literature} {Review}: {An} {Exploration} of {RAND} {Corporation}’s 20-{Year} {Corpus}	2024	Ambiguo sin abstract
islam_open-rag_2024	{OPEN}-{RAG}: {Enhanced} {Retrieval}-{Augmented} {Reasoning} with {Open}-{Source} {Large} {Language} {Models}	2024	Ambiguo sin abstract
firsanova_graph-based_2024	A graph-based approach to closed-domain natural language generation; Новый графовый подход к генерации текстов узкой предметной области на естественном языке	2024	Ambiguo sin abstract
collado-montanez_separating_2024	Separating {Linguistic} {Competence} from {Factual} {Knowledge} in {Large} {Language} {Models}	2024	Ambiguo sin abstract
kim_thorr_2024	{THoRR}: {Complex} {Table} {Retrieval} and {Refinement} for {RAG}	2024	Ambiguo sin abstract
zerhoudi_personarag_2024	{PersonaRAG}: {Enhancing} {Retrieval}-{Augmented} {Generation} {Systems} with {User}-{Centric} {Agents}	2024	Ambiguo sin abstract
ordonez-camacho_aurel_ai_2024	Aurel\_AI: {Automating} an {Institutional} {Help} {Desk} {Using} an {LLM} {Chatbot}	2024	Ambiguo sin abstract
cvetkovic_semantic_2024	Semantic {Exploration} of {Industrial} {Standards} {Using} {Large} {Language} {Models}	2024	Ambiguo sin abstract
noauthor_proceedings_2024-2	Proceedings - 2024 {International} {Conference} on {Networking} and {Network} {Applications}, {NaNA} 2024	2024	Ambiguo sin abstract
oro_evaluating_2024	Evaluating {Retrieval}-{Augmented} {Generation} for {Question} {Answering} with {Large} {Language} {Models}	2024	Ambiguo sin abstract
liu_ra-isf_2024	{RA}-{ISF}: {Learning} to {Answer} and {Understand} from {Retrieval} {Augmentation} via {Iterative} {Self}-{Feedback}	2024	Ambiguo sin abstract
hsieh_found_2024	Found in the middle: {Calibrating} {Positional} {Attention} {Bias} {Improves} {Long} {Context} {Utilization}	2024	Ambiguo sin abstract
xiong_benchmarking_2024	Benchmarking {Retrieval}-{Augmented} {Generation} for {Medicine}	2024	Ambiguo sin abstract
enouen_textgenshap_2024	{TextGenSHAP}: {Scalable} {Post}-hoc {Explanations} in {Text} {Generation} with {Long} {Documents}	2024	Ambiguo sin abstract
zhang_retrievalqa_2024	{RetrievalQA}: {Assessing} {Adaptive} {Retrieval}-{Augmented} {Generation} for {Short}-form {Open}-{Domain} {Question} {Answering}	2024	Ambiguo sin abstract
chu_patent_2024	Patent {Response} {System} {Optimised} for {Faithfulness}: {Procedural} {Knowledge} {Embodiment} with {Knowledge} {Graph} and {Retrieval} {Augmented} {Generation}	2024	Ambiguo sin abstract
buhnila_retrieve_2024	Retrieve, {Generate}, {Evaluate}: {A} {Case} {Study} for {Medical} {Paraphrases} {Generation} with {Small} {Language} {Models}	2024	Ambiguo sin abstract
noauthor_knowllm_2024	{KnowLLM} 2024 - 1st {Workshop} on {Towards} {Knowledgeable} {Language} {Models}, {Proceedings} of the {Workshop}	2024	Ambiguo sin abstract
noauthor_knowledgenlp_2024	{KnowledgeNLP} 2024 - 3rd {Workshop} on {Knowledge} {Augmented} {Methods} for {NLP}, {Proceedings} of the {Workshop}	2024	Ambiguo sin abstract
yokoyama_aggregating_2024	Aggregating {Impressions} on {Celebrities} and their {Reasons} from {Microblog} {Posts} and {Web} {Search} {Pages} by {LLMs}	2024	Ambiguo sin abstract
addad_homeopathic_2024	Homeopathic {Poisoning} of {RAG} {Systems}	2024	Ambiguo sin abstract
fang_enhancing_2024	Enhancing {Noise} {Robustness} of {Retrieval}-{Augmented} {Language} {Models} with {Adaptive} {Adversarial} {Training}	2024	Ambiguo sin abstract
jacobs_leveraging_2024	Leveraging {Lecture} {Content} for {Improved} {Feedback}: {Explorations} with {GPT}-4 and {Retrieval} {Augmented} {Generation}	2024	Ambiguo sin abstract
agarwal_symkgqa_2024	{SymKGQA}: {Few}-{Shot} {Knowledge} {Graph} {Question} {Answering} via {Symbolic} {Program} {Generation} and {Execution}	2024	Ambiguo sin abstract
zhang_arl2_2024	{ARL2}: {Aligning} {Retrievers} for {Black}-box {Large} {Language} {Models} via {Self}-guided {Adaptive} {Relevance} {Labeling}	2024	Ambiguo sin abstract
fernandez_syllabusqa_2024	{SYLLABUSQA}: {A} {Course} {Logistics} {Question} {Answering} {Dataset}	2024	Ambiguo sin abstract
fore_unlearning_2024	Unlearning {Climate} {Misinformation} in {Large} {Language} {Models}	2024	Ambiguo sin abstract
wan_what_2024	What {Evidence} {Do} {Language} {Models} {Find} {Convincing}?	2024	Ambiguo sin abstract
chen_vullibgen_2024	{VulLibGen}: {Generating} {Names} of {Vulnerability}-{Affected} {Packages} via a {Large} {Language} {Model}	2024	Ambiguo sin abstract
nguyen_my_2024	My {Climate} {Advisor}: {An} {Application} of {NLP} in {Climate} {Adaptation} for {Agriculture}	2024	Ambiguo sin abstract
shi_generate-then-ground_2024	Generate-then-{Ground} in {Retrieval}-{Augmented} {Generation} for {Multi}-hop {Question} {Answering}	2024	Ambiguo sin abstract
maharana_evaluating_2024	Evaluating {Very} {Long}-{Term} {Conversational} {Memory} of {LLM} {Agents}	2024	Ambiguo sin abstract
wendelken_roux-lette_2024	Roux-lette at “{Discharge} {Me}!”: {Reducing} {EHR} {Chart} {Burden} with a {Simple}, {Scalable}, {Clinician}-{Driven} {AI} {Approach}	2024	Ambiguo sin abstract
srinivasagan_retrieval_2024	Retrieval {Augmented} {Spoken} {Language} {Generation} for {Transport} {Domain}	2024	Ambiguo sin abstract
basaragin_how_2024	How do you know that? {Teaching} {Generative} {Language} {Models} to {Reference} {Answers} to {Biomedical} {Questions}	2024	Ambiguo sin abstract
han_improving_2024	Improving {Assessment} of {Tutoring} {Practices} using {Retrieval}-{Augmented} {Generation}	2024	Ambiguo sin abstract
noauthor_proceedings_2024-3	Proceedings of the 2024 {AAAI} {Conference} on {Artificial} {Intelligence}	2024	Ambiguo sin abstract
zhang_trustworthy_2024	Trustworthy {Alignment} of {Retrieval}-{Augmented} {Large} {Language} {Models} via {Reinforcement} {Learning}	2024	Ambiguo sin abstract
li_role_2024	On the {Role} of {Long}-tail {Knowledge} in {Retrieval} {Augmented} {Large} {Language} {Models}	2024	Ambiguo sin abstract
monea_glitch_2024	A {Glitch} in the {Matrix}? {Locating} and {Detecting} {Language} {Model} {Grounding} with {Fakepedia}	2024	Ambiguo sin abstract
kuppa_manipulating_2024	Manipulating {Prompts} and {Retrieval}-{Augmented} {Generation} for {LLM} {Service} {Providers}	2024	Ambiguo sin abstract
mamalis_large_2024	A {Large} {Language} {Model} {Agent} {Based} {Legal} {Assistant} for {Governance} {Applications}	2024	Ambiguo sin abstract
otto_enhancing_2024	Enhancing {Software}-{Related} {Information} {Extraction} via {Single}-{Choice} {Question} {Answering} with {Large} {Language} {Models}	2024	Ambiguo sin abstract
wang_csprd_2024	{CSPRD}: {A} {Financial} {Policy} {Retrieval} {Dataset} for {Chinese} {Stock} {Market}	2024	Ambiguo sin abstract
rehulka_rag_2024	{RAG} {Meets} {Detox}: {Enhancing} {Text} {Detoxification} {Using} {Open} {Large} {Language} {Models} with {Retrieval} {Augmented} {Generation}	2024	Ambiguo sin abstract
xu_enhancing_2024	Enhancing {Retrieval}-{Augmented} {Generation} {Models} with {Knowledge} {Graphs}: {Innovative} {Practices} {Through} a {Dual}-{Pathway} {Approach}	2024	Ambiguo sin abstract
kawashima_development_2024	Development of {RAG} {System} for {Digital} {Transformation} of {Local} {Government} and {Considering} {Optimal} {Document}-{Segmentation} {Methods}	2024	Ambiguo sin abstract
miladi_comparative_2024	Comparative {Performance} of {GPT}-4, {RAG}-{Augmented} {GPT}-4, and {Students} in {MOOCs}	2024	Ambiguo sin abstract
kamel_boulos_nvidias_2024	{NVIDIA}’s “{Chat} with {RTX}” {Custom} {Large} {Language} {Model} and {Personalized} {AI} {Chatbot} {Augments} the {Value} of {Electronic} {Dermatology} {Reference} {Material}	2024	Ambiguo sin abstract
asai_self-rag_2024	{SELF}-{RAG}: {LEARNING} {TO} {RETRIEVE}, {GENERATE}, {AND} {CRITIQUE} {THROUGH} {SELF}-{REFLECTION}	2024	Ambiguo sin abstract
ko_enhancing_2024	Enhancing {Python} {Learning} {Through} {Retrieval}-{Augmented} {Generation}: {A} {Theoretical} and {Applied} {Innovation} in {Generative} {AI} {Education}	2024	Ambiguo sin abstract
li_traq_2024	{TRAQ}: {Trustworthy} {Retrieval} {Augmented} {Question} {Answering} via {Conformal} {Prediction}	2024	Ambiguo sin abstract
sokolov_generative_2024	Generative {Reader} {Optimization} in the {RAG}-{System}	2024	Ambiguo sin abstract
noauthor_32nd_2024	32nd {International} {Conference} on {Case}-{Based} {Reasoning}, {ICCBR} 2024	2024	Ambiguo sin abstract
omeed_integrating_2024	Integrating {Computer} {Vision} and language model for interactive {AI} - {Robot}	2024	Ambiguo sin abstract
li_alphafin_2024	{AlphaFin}: {Benchmarking} {Financial} {Analysis} with {Retrieval}-{Augmented} {Stock}-{Chain} {Framework}	2024	Ambiguo sin abstract
tishechkin_improve_2024	Improve {Geoscience} interpretation, reporting, and transparency with {Generative} {AI}	2024	Ambiguo sin abstract
welz_enhancing_2024	Enhancing {Large} {Language} {Models} {Through} {External} {Domain} {Knowledge}	2024	Ambiguo sin abstract
gonzalez_torres_automated_2024	Automated {Question}-{Answer} {Generation} for {Evaluating} {RAG}-based {Chatbots}	2024	Ambiguo sin abstract
yang_yangqi_2024	yangqi at {SemEval}-2024 {Task} 9: {Simulate} {Human} {Thinking} by {Large} {Language} {Model} for {Lateral} {Thinking} {Challenges}	2024	Ambiguo sin abstract
wijesinghe_artificial_2024	Artificial {Intelligence} {Model} to {Suggest} {Sewing} {Operations} {Through} {Sketch} {Analysis}	2024	Ambiguo sin abstract
mosser_exploration_2024	Exploration {Robot} {Chat}: {Uncovering} {Decades} of {Exploration} {Knowledge} and {Data} with {Conversational} {Large} {Language} {Models}	2024	Ambiguo sin abstract
he_quality_2024	Quality of {Answers} of {Generative} {Large} {Language} {Models} {Versus} {Peer} {Users} for {Interpreting} {Laboratory} {Test} {Results} for {Lay} {Patients}: {Evaluation} {Study}	2024	Ambiguo sin abstract
ghodratnama_adapting_2024	Adapting {LLMs} for {Efficient}, {Personalized} {Information} {Retrieval}: {Methods} and {Implications}	2024	Ambiguo sin abstract
anantha_context_2024	Context {Tuning} for {Retrieval} {Augmented} {Generation}	2024	Ambiguo sin abstract
noauthor_uncertainlp_2024	{UncertaiNLP} 2024 - {Workshop} on {Uncertainty}-{Aware} {NLP}, {Proceedings} of the {Workshop}	2024	Ambiguo sin abstract
wolfel_knowledge-based_2024	Knowledge-{Based} and {Generative}-{AI}-{Driven} {Pedagogical} {Conversational} {Agents}: {A} {Comparative} {Study} of {Grice}’s {Cooperative} {Principles} and {Trust}	2024	Ambiguo sin abstract
zhou_preliminary_2024-1	Preliminary {Research} on {Applications} of {Large} {Language} {Models} in {E}\&{P} {Industry}	2024	Ambiguo sin abstract
jobanputra_teamsaarlst_2024	{TeamSaarLST} at the {GEM}'24 {Data}-to-text {Task}: {Revisiting} symbolic retrieval in the {LLM}-age	2024	Ambiguo sin abstract
umrao_detecting_2024	Detecting {Hallucinations} in {Textual} {Data}: {Insights} {From} {Machine} {Learning} {Models} in {Contextual} {QA}	2024	Ambiguo sin abstract
feridooni_development_2024	Development of a vascular surgery-specific artificial intelligence chat interface using retrieval-augmented generation: {VASC}.{AI}, a specialized vascular surgery chatbot	2024	Ambiguo sin abstract
fahmi_retrieval-augmented_2024	Retrieval-{Augmented} {Generation} for {Pharmacopoeia}: {Application} and {Evaluation}	2024	Ambiguo sin abstract
soularidis_llm-assisted_2024	{LLM}-{Assisted} {Generation} of {SWRL} {Rules} from {Natural} {Language}	2024	Ambiguo sin abstract
sinha_fact-centric_2024	Fact-{Centric} {Knowledge} {Web} for {Information} {Retrieval}	2024	Ambiguo sin abstract
jayawardene_tablinkllm_2024	{TabLinkLLM}: {An} {LLM}-{Based} {Approach} for {Entity} {Linking} in {Tabular} {Data}	2024	Ambiguo sin abstract
kulkarni_bankbot_2024	{BankBot}: {Streamlined} {Banking} {Support} {Through} {Centralized} {FAQs}	2024	Ambiguo sin abstract
kumari_innovative_2024	Innovative {Corporate} {Query} handling with {Domain}-{Specific} {RAG}	2024	Ambiguo sin abstract
sinha_healthcare_2024	Healthcare {Diagnostic} {RAG}-{Based} {Chatbot} {Triage} {Enabled} by {BioMistral}-{7B}	2024	Ambiguo sin abstract
kamath_large_2024	Large {Language} {Models}: {A} {Deep} {Dive}: {Bridging} {Theory} and {Practice}	2024	Ambiguo sin abstract
nurhayati_performance_2024	Performance {Evaluation} of a {Chatbot} with {Retrieval} {Augmented} {Generation} and {Generative} {Pre}-trained {Transformer}-4 {Model} for {Taharah} {Domain}	2024	Ambiguo sin abstract
gupta_databricks_2024	Databricks {Data} {Intelligence} {Platform}: {Unlocking} the {GenAI} {Revolution}	2024	Ambiguo sin abstract
toxopeus_accelerate_2024	Accelerate your subsurface workflow: chatting with your data using custom plugins	2024	Ambiguo sin abstract
kurniawan_cykg-rag_2024	{CyKG}-{RAG}: {Towards} knowledge-graph enhanced retrieval augmented generation for cybersecurity	2024	Ambiguo sin abstract
xu_knowledge_2024	Knowledge {Graph}-{Enhanced} {Retrieval} {Augmented} {Generation} for {E}-{Commerce}	2024	Ambiguo sin abstract
garigliotti_retrieval-augmented_2024	Retrieval-{Augmented} {Generation} for {Query} {Target} {Type} {Identification}	2024	Ambiguo sin abstract
gonzalez_generative_2024	Generative {AI}-{Enabled} {Chatbot} for {Improving} {Students}’ {Understanding} and {Awareness} of {Academic} {Integrity} {Policies}	2024	Ambiguo sin abstract
barron_domain-specific_2024	Domain-{Specific} {Retrieval}-{Augmented} {Generation} {Using} {Vector} {Stores}, {Knowledge} {Graphs}, and {Tensor} {Factorization}	2024	Ambiguo sin abstract
zhang_knowgpt_2024	{KnowGPT}: {Knowledge} {Graph} based {PrompTing} for {Large} {Language} {Models}	2024	Ambiguo sin abstract
zhou_boosting_2024	Boosting the {Potential} of {Large} {Language} {Models} with an {Intelligent} {Information} {Assistant}	2024	Ambiguo sin abstract
chow_unified_2024	Unified {Generative} and {Discriminative} {Training} for {Multi}-modal {Large} {Language} {Models}	2024	Ambiguo sin abstract
shi_reference_2024	Reference {Trustable} {Decoding}: {A} {Training}-{Free} {Augmentation} {Paradigm} for {Large} {Language} {Models}	2024	Ambiguo sin abstract
oreski_retrieval_2024	Retrieval {Augmented} {Generation} in {Large} {Language} {Models}: {Development} of {AI} {Chatbot} for {Student} {Support}	2024	Ambiguo sin abstract
choi_combining_2024	Combining {Multiple} {Metrics} for {Evaluating} {Retrieval}-{Augmented} {Conversations}	2024	Ambiguo sin abstract
ramoneda_role_2024	The {Role} of {Large} {Language} {Models} in {Musicology}: {Are} {We} {Ready} to {Trust} the {Machines}?	2024	Ambiguo sin abstract
shavaki_knowledge_2024	Knowledge {Graph} {Based} {Retrieval}-{Augmented} {Generation} for {Multi}-{Hop} {Question} {Answering} {Enhancement}	2024	Ambiguo sin abstract
earley_what_2023	What executives need to know about knowledge management, large language models and generative {AI}	2023	Ambiguo sin abstract
yang_retrieval-augmented_2023	Retrieval-{Augmented} {Generation} with {Quantized} {Large} {Language} {Models}: {A} {Comparative} {Analysis}	2023	Ambiguo sin abstract
sarmah_towards_2023	Towards reducing hallucination in extracting information from financial reports using {Large} {Language} {Models}	2023	Ambiguo sin abstract
cheng_lift_2023	Lift {Yourself} {Up}: {Retrieval}-augmented {Text} {Generation} with {Self}-{Memory}	2023	Ambiguo sin abstract
shao_enhancing_2023	Enhancing {Retrieval}-{Augmented} {Large} {Language} {Models} with {Iterative} {Retrieval}-{Generation} {Synergy}	2023	Ambiguo sin abstract
anand_sciphyrag_2023	{SciPhyRAG} - {Retrieval} {Augmentation} to {Improve} {LLMs} on {Physics} {Q} \&{A}	2023	Ambiguo sin abstract
datta_great_2023	{GREAT} {AI} in {Medical} {Appropriateness} and {Value}-{Based}-{Care}	2023	Ambiguo sin abstract
jiang_active_2023	Active {Retrieval} {Augmented} {Generation}	2023	Ambiguo sin abstract
